Educational level ID,Educational level,Family ID,Family,Salary,Movement Balance,Admissions,Resignations
1,Analfabeto,0000,Não especificado,2243.657666015625,79,223,144
1,Analfabeto,0101,Oficiais Generais Das Forças Armadas,1533.588809742647,1,10,9
1,Analfabeto,0103,Praças Das Forças Armadas,2035.020004272461,2,4,2
1,Analfabeto,0301,Oficiais Superiores Do Corpo De Bombeiros Militar,1200,-1,0,1
1,Analfabeto,1111,Legisladores,1357.37998046875,3,5,2
1,Analfabeto,1112,Dirigentes Gerais Da Administração Pública,2720.6399953741775,10,15,5
1,Analfabeto,1114,Dirigentes Do Serviço Público,1561.6443411654593,76,119,43
1,Analfabeto,1115,Gestores Públicos,3385.0992290790264,17,22,5
1,Analfabeto,1142,Dirigentes E Administradores De Entidades Patronais E Dos Trabalhadores E De Outros Interesses Sócioeconômicos,6433.56982421875,0,1,1
1,Analfabeto,1143,Dirigentes E Administradores De Entidades Religiosas,2464.800048828125,0,1,1
1,Analfabeto,1144,Dirigentes E Administradores De Organizações Da Sociedade Civil Sem Fins Lucrativos,1230,2,2,0
1,Analfabeto,1210,Diretores Gerais,6438.6875562480855,-12,14,26
1,Analfabeto,1222,"Diretores De Produção E Operações Em Empresa Da Indústria Extrativa, Transformação E De Serviços De Utilidade Pública",15527.09521484375,0,1,1
1,Analfabeto,1223,Diretores De Operações De Obras Em Empresa De Construção,2363.133341471354,3,3,0
1,Analfabeto,1224,Diretores De Operações Em Empresa Do Comércio,11064.5048828125,-2,0,2
1,Analfabeto,1225,"Diretores De Serviços De Turismo, De Alojamento E De Alimentação",6687.025065104167,0,2,2
1,Analfabeto,1226,"Diretores De Operações De Serviços Em Empresa De Armazenamento, De Transporte E De Telecomunicação",17645.15625,0,2,2
1,Analfabeto,1227,Diretores De Operações De Serviços Em Instituição De Intermediação Financeira,102625,0,1,1
1,Analfabeto,1231,Diretores Administrativos E Financeiros,10008.275526032625,2,40,38
1,Analfabeto,1233,Diretores De Comercialização E Marketing,13020.294300752528,-4,8,12
1,Analfabeto,1234,Diretores De Suprimentos E Afins,1700,2,2,0
1,Analfabeto,1236,Diretores De Tecnologia Da Informação,26819.909830729168,-3,0,3
1,Analfabeto,1238,Diretores De Manutenção,1926.5133463541667,-1,1,2
1,Analfabeto,1311,"Diretores E Gerentes De Operações Em Empresa De Serviços Pessoais, Sociais E Culturais",3213.871907043457,1,33,32
1,Analfabeto,1312,"Gestores E Especialistas De Operações Em Empresas, Secretarias E Unidades De Serviços De Saúde",8116.1188167317705,-5,15,20
1,Analfabeto,1313,Diretores E Gerentes De Instituição De Serviços Educacionais,3394.763125213922,-3,25,28
1,Analfabeto,1411,"Gerentes De Produção E Operações Em Empresa Agropecuária, Pesqueira, Aqüícola E Florestal",5719.285136729111,11,116,105
1,Analfabeto,1412,"Gerentes De Produção E Operações Em Empresa Da Indústria Extrativa, De Transformação E De Serviços De Utilidade Pública",3872.8332432988864,26,147,121
1,Analfabeto,1413,Gerentes De Obras Em Empresa De Construção,4568.822068647904,0,22,22
1,Analfabeto,1414,Gerentes De Operações Comerciais E De Assistência Técnica,2214.2161934308165,-30,338,368
1,Analfabeto,1415,"Gerentes De Operações De Serviços Em Empresa De Turismo, De Alojamento E Alimentação",2608.524023709005,30,161,131
1,Analfabeto,1416,"Gerentes De Operações De Serviços Em Empresa De Transporte, De Comunicação E De Logística (Armazenagem E Distribuição)",5309.961022186596,0,59,59
1,Analfabeto,1417,Gerentes De Operações De Serviços Em Instituição De Intermediação Financeira,8829.530322265626,-5,3,8
1,Analfabeto,1418,Gerentes Operacionais Da Aviação Civil,12500,-1,1,2
1,Analfabeto,1421,"Gerentes Administrativos, Financeiros, De Riscos E Afins",6492.887479284463,2,405,403
1,Analfabeto,1422,Gerentes De Recursos Humanos E De Relações Do Trabalho,6173.995649852707,-7,43,50
1,Analfabeto,1423,"Gerentes De Comercialização, Marketing E Comunicação",5688.29656975985,-60,579,639
1,Analfabeto,1424,Gerentes De Suprimentos E Afins,4730.888931274414,-12,20,32
1,Analfabeto,1425,Gerentes De Tecnologia Da Informação,8916.68374501867,-24,39,63
1,Analfabeto,1426,Gerentes De Pesquisa E Desenvolvimento E Afins,18089.21440633138,-6,15,21
1,Analfabeto,1427,Gerentes De Manutenção E Afins,6252.480655924479,11,28,17
1,Analfabeto,2011,Profissionais Da Biotecnologia,1870.3350830078125,-1,2,3
1,Analfabeto,2012,Profissionais Da Metrologia,2150,-2,0,2
1,Analfabeto,2021,"Engenheiros De Controle E Automação, Engenheiros Mecatrônicos E Afins",3421.5487365722656,-5,4,9
1,Analfabeto,2030,Pesquisadores Das Ciências Biológicas,3850,1,2,1
1,Analfabeto,2031,Pesquisadores Das Ciências Naturais E Exatas,8001.5052490234375,-4,5,9
1,Analfabeto,2032,Pesquisadores De Engenharia E Tecnologia,5775.9130386352535,-3,5,8
1,Analfabeto,2033,Pesquisadores Das Ciências Da Saúde,4045.9625040690103,0,3,3
1,Analfabeto,2034,Pesquisadores Das Ciências Da Agricultura,2743.3333333333335,0,2,2
1,Analfabeto,2035,Pesquisadores Das Ciências Sociais E Humanas,5119.8566487630205,6,8,2
1,Analfabeto,2111,Profissionais Da Matemática,3452.3578563017004,2,10,8
1,Analfabeto,2122,Engenheiros Em Computação,12028.053905345776,-9,11,20
1,Analfabeto,2123,Administradores De Tecnologia Da Informação,5997.061676667866,7,27,20
1,Analfabeto,2124,Analistas De Tecnologia Da Informação,5596.014815689214,-121,348,469
1,Analfabeto,2132,Químicos,2816.9682508680557,-1,4,5
1,Analfabeto,2133,Profissionais Das Ciências Atmosféricas E Espaciais E De Astronomia,2500,-1,0,1
1,Analfabeto,2134,"Geólogos, Oceanógrafos, Geofísicos E Afins",6074.21904296875,-3,3,6
1,Analfabeto,2140,Engenheiros Ambientais E Afins,4895.780021158855,2,5,3
1,Analfabeto,2141,Arquitetos E Urbanistas,5616.512534877233,-3,10,13
1,Analfabeto,2142,Engenheiros Civis E Afins,8200.327756305716,-21,35,56
1,Analfabeto,2143,"Engenheiros Eletricistas, Eletrônicos E Afins",7709.304542002052,-4,14,18
1,Analfabeto,2144,Engenheiros Mecânicos E Afins,11644.583093067957,-74,30,104
1,Analfabeto,2145,Engenheiros Químicos E Afins,7667.676611328125,2,5,3
1,Analfabeto,2146,"Engenheiros Metalurgistas, De Materiais E Afins",8760.726888020834,-1,1,2
1,Analfabeto,2147,Engenheiros De Minas E Afins,11369.66259765625,0,3,3
1,Analfabeto,2148,Engenheiros Agrimensores E Engenheiros Cartógrafos,576.469970703125,-1,0,1
1,Analfabeto,2149,"Engenheiros De Produção, Qualidade, Segurança E Afins",6728.267608395029,11,59,48
1,Analfabeto,2151,Oficiais De Convés E Afins,1698.6583211263019,0,5,5
1,Analfabeto,2152,Oficiais De Máquinas Da Marinha Mercante,2776.42333984375,1,3,2
1,Analfabeto,2153,Profissionais Da Pilotagem Aeronáutica,3735.259239783654,3,9,6
1,Analfabeto,2211,Biólogos E Afins,3461.0338698167066,-9,2,11
1,Analfabeto,2212,Biomédicos,2573.5598213627654,-3,25,28
1,Analfabeto,2221,Engenheiros Agrossilvipecuários,5092.805335998535,2,9,7
1,Analfabeto,2232,Cirurgiões-Dentistas,4818.305408112899,5,22,17
1,Analfabeto,2233,Veterinários E Zootecnistas,2391.2765268179087,-1,20,21
1,Analfabeto,2234,Farmacêuticos,4983.670196337078,0,152,152
1,Analfabeto,2235,Enfermeiros E Afins,4370.672911526878,-35,293,328
1,Analfabeto,2236,Fisioterapeutas,3396.120445928414,12,79,67
1,Analfabeto,2237,Nutricionistas,3293.2160208565847,17,79,62
1,Analfabeto,2238,Fonoaudiólogos,2842.705898030599,6,24,18
1,Analfabeto,2239,"Terapeutas Ocupacionais, Ortoptistas E Psicomotricistas",2522.705603027344,1,14,13
1,Analfabeto,2241,Profissionais Da Educação Física,7733.910680636313,28,141,113
1,Analfabeto,2251,Médicos Clínicos,8693.410288992136,-28,65,93
1,Analfabeto,2252,Médicos Em Especialidades Cirúrgicas,4112.720165143694,-18,3,21
1,Analfabeto,2253,Médicos Em Medicina Diagnóstica E Terapêutica,5612.2001546223955,3,4,1
1,Analfabeto,2311,Professores De Nível Superior Na Educação Infantil,4616.940016842736,-23,114,137
1,Analfabeto,2312,Professores De Nível Superior Do Ensino Fundamental (Primeira A Quarta Séries),4296.909862146729,-38,175,213
1,Analfabeto,2313,Professores De Nível Superior No Ensino Fundamental De Quinta A Oitava Série,2536.8934960436927,-9,93,102
1,Analfabeto,2321,Professores Do Ensino Médio,2485.4448051363593,-23,73,96
1,Analfabeto,2331,Professores Do Ensino Profissional,2397.1583082411025,-7,2,9
1,Analfabeto,2332,Instrutores De Ensino Profissional,2288.640973081215,-42,40,82
1,Analfabeto,2341,"Professores De Matemática, Estatística E Informática Do Ensino Superior",437.5,-2,0,2
1,Analfabeto,2342,"Professores De Ciências Físicas, Químicas E Afins Do Ensino Superior",0,1,1,0
1,Analfabeto,2343,"Professores De Arquitetura E Urbanismo, Engenharia, Geofísica E Geologia Do Ensino Superior",3653.7804005940757,-9,1,10
1,Analfabeto,2344,Professores De Ciências Biológicas E Da Saúde Do Ensino Superior,2444.6502307103906,-2,17,19
1,Analfabeto,2345,Professores Na Área De Formação Pedagógica Do Ensino Superior,5656.018652646295,-96,69,165
1,Analfabeto,2346,Professores Nas Áreas De Língua E Literatura Do Ensino Superior,2055.0074166843565,-5,42,47
1,Analfabeto,2347,Professores De Ciências Humanas Do Ensino Superior,3117.426041428248,-3,8,11
1,Analfabeto,2348,"Professores De Ciências Econômicas, Administrativas E Contábeis Do Ensino Superior",2995.626037522858,-6,8,14
1,Analfabeto,2349,Professores De Artes Do Ensino Superior,5436.835986328125,-3,2,5
1,Analfabeto,2392,Professores De Educação Especial,2923.8169795017616,-30,26,56
1,Analfabeto,2394,"Programadores, Avaliadores E Orientadores De Ensino",2138.2788508598783,-19,133,152
1,Analfabeto,2410,Advogados,4827.87084183913,-3,78,81
1,Analfabeto,2413,Tabeliães E Registradores,1018.5320511658987,20,28,8
1,Analfabeto,2429,Profissionais Da Inteligência,3125,2,2,0
1,Analfabeto,2511,Profissionais Em Pesquisa E Análise Antropológica Sociológica,3643.56494140625,-2,0,2
1,Analfabeto,2512,Economistas,4248.083834579293,2,37,35
1,Analfabeto,2515,Psicólogos E Psicanalistas,2630.930502975274,13,62,49
1,Analfabeto,2516,Assistentes Sociais E Economistas Domésticos,2932.1841410090415,-8,42,50
1,Analfabeto,2521,Administradores,5395.385317893433,182,477,295
1,Analfabeto,2522,Contadores E Afins,4093.667338529239,15,162,147
1,Analfabeto,2523,Secretárias(Os) Executivas(Os) E Afins,1773.1920878147773,19,232,213
1,Analfabeto,2524,Profissionais De Recursos Humanos,3342.8174994169776,36,152,116
1,Analfabeto,2525,Profissionais De Administração Ecônomico-Financeira,3775.027033683581,21,92,71
1,Analfabeto,2526,Profissionais Da Administração Dos Serviços De Segurança,10673.274344308036,-3,2,5
1,Analfabeto,2527,"Profissionais De Planejamento, Programação E Controles Logisticos",3870.5469104049334,3,36,33
1,Analfabeto,2531,Profissionais De Publicidade,5685.4162878995,24,99,75
1,Analfabeto,2532,Profissionais De Comercializacão E Consultoria De Serviços Bancários,6105.811969327059,-12,62,74
1,Analfabeto,2533,"Corretores De Valores, Ativos Financeiros, Mercadorias E Derivativos",3965.424298967634,4,9,5
1,Analfabeto,2534,Profissionais De Mídias Digitais E Afins,1860.0199890136719,-6,5,11
1,Analfabeto,2543,Auditores Fiscais Do Trabalho,1657.0908871968586,1,42,41
1,Analfabeto,2544,Fiscais De Tributos Estaduais E Municipais,3101.552978515625,-1,3,4
1,Analfabeto,2545,Profissionais Da Fiscalização De Atividades Urbanas,2240.8699951171875,-1,2,3
1,Analfabeto,2611,Profissionais Do Jornalismo,3643.937438542186,2,39,37
1,Analfabeto,2612,Profissionais Da Informação,3515.3099198973737,-10,26,36
1,Analfabeto,2613,Arquivistas E Museólogos,1404.3800033789414,-1,6,7
1,Analfabeto,2614,"Filólogos,Tradutores ,Intérpretes E Afins",2484.2343978881836,-8,7,15
1,Analfabeto,2615,Profissionais Da Escrita,2513.760813395182,3,6,3
1,Analfabeto,2616,Editores,6129.927764892578,-1,3,4
1,Analfabeto,2617,"Locutores, Comentaristas E Repórteres De Mídias Audiovisuais",5212.746170552571,-4,15,19
1,Analfabeto,2618,Fotógrafos Profissionais,1378.8905855066635,4,12,8
1,Analfabeto,2621,Produtores Artísticos E Culturais,3207.0989292931936,-7,17,24
1,Analfabeto,2622,Diretores De Espetáculos E Afins,7203.9501953125,0,1,1
1,Analfabeto,2623,Cenógrafos,13492,3,4,1
1,Analfabeto,2624,"Artistas Visuais,Desenhistas Industriais E Conservadores-Restauradores De Bens Culturais",2674.54877985174,51,155,104
1,Analfabeto,2625,Atores,14618.646209716797,4,6,2
1,Analfabeto,2626,"Músicos Compositores, Arranjadores, Regentes E Musicólogos",1686.4722222222222,3,7,4
1,Analfabeto,2627,Músicos Intérpretes,834.4533487955729,0,2,2
1,Analfabeto,2628,Artistas Da Dança (Exceto Dança Tradicional E Popular),9047.635366586539,-2,6,8
1,Analfabeto,2629,Designer De Interiores De Nível Superior,2666.6666666666665,1,2,1
1,Analfabeto,2631,"Ministros De Culto, Missionários, Teólogos E Profissionais Assemelhados",1261.496542794364,-1,7,8
1,Analfabeto,2711,Chefes De Cozinha E Afins,7658.848171111076,9,99,90
1,Analfabeto,3001,Técnicos Em Mecatrônica,4307.677951388889,-8,23,31
1,Analfabeto,3003,Técnicos Em Eletromecânica,3324.6953637393904,40,101,61
1,Analfabeto,3011,Técnicos De Laboratório Industrial,2593.815579958622,35,153,118
1,Analfabeto,3012,Técnicos De Apoio À Bioengenharia,3661.375,-2,0,2
1,Analfabeto,3111,Técnicos Químicos,2265.9132829938617,1,36,35
1,Analfabeto,3113,"Técnicos Em Materiais, Produtos Cerâmicos E Vidros",2850.614990234375,0,3,3
1,Analfabeto,3114,Técnicos Em Fabricação De Produtos Plásticos E De Borracha,2205.137499128069,-2,7,9
1,Analfabeto,3115,"Técnicos Em Controle Ambiental, Utilidades E Tratamento De Efluentes",2112.3294964029333,13,72,59
1,Analfabeto,3116,Técnicos Têxteis,1400,1,1,0
1,Analfabeto,3117,Coloristas,2477.076368411123,-28,329,357
1,Analfabeto,3121,Técnicos Em Construção Civil (Edificações),2753.7570417957195,23,96,73
1,Analfabeto,3122,Técnicos Em Construção Civil (Obras De Infraestrutura),2035.4921231656463,21,64,43
1,Analfabeto,3123,Técnicos Em Geomática,2360.3355068630644,13,99,86
1,Analfabeto,3131,Técnicos Em Eletricidade E Eletrotécnica,3126.3114718742504,435,816,381
1,Analfabeto,3132,Técnicos Em Eletrônica,2445.918361189885,38,245,207
1,Analfabeto,3133,Técnicos Em Telecomunicações,1850.4933478588396,4,111,107
1,Analfabeto,3134,Técnicos Em Calibração E Instrumentação,3531.6007995543273,-16,47,63
1,Analfabeto,3135,Técnicos Em Fotônica,1391.512001953125,7,16,9
1,Analfabeto,3141,"Técnicos Mecânicos Na Fabricação E Montagem De Máquinas, Sistemas E Instrumentos",3352.424732807255,53,172,119
1,Analfabeto,3142,Técnicos Mecânicos (Ferramentas),2694.6841227213545,-5,3,8
1,Analfabeto,3143,Técnicos Em Mecânica Veicular,3605.774643670945,-28,8,36
1,Analfabeto,3144,"Técnicos Mecânicos Na Manutenção De Máquinas, Sistemas E Instrumentos",2697.933140995628,10,132,122
1,Analfabeto,3146,Técnicos Em Metalurgia (Estruturas Metálicas),2949.244814046224,6,19,13
1,Analfabeto,3147,Técnicos Em Siderurgia,2662,-2,0,2
1,Analfabeto,3148,Especialistas Em Inspeções Industriais,6956.551595052084,2,5,3
1,Analfabeto,3161,Técnicos Em Geologia,1968.4459273726852,4,9,5
1,Analfabeto,3163,Técnicos Em Mineração,2933.972638165509,2,7,5
1,Analfabeto,3171,Técnicos De Desenvolvimento De Sistemas E Aplicações,8759.625324602806,-32,101,133
1,Analfabeto,3172,Técnicos De Suporte E Monitoração Ao Usuário De Tecnologia Da Informação.,5563.134185756067,25,165,140
1,Analfabeto,3180,"Desenhistas Técnicos, Em Geral",3746.2973144531247,4,24,20
1,Analfabeto,3181,Desenhistas Técnicos Da Construção Civil E Arquitetura,2639.5501767672026,2,12,10
1,Analfabeto,3182,Desenhistas Técnicos Da Mecânica,2684.20751953125,0,4,4
1,Analfabeto,3183,"Desenhistas Técnicos Em Eletricidade, Eletrônica, Eletromecânica, Calefação, Ventilação E Refrigeração",1700,1,2,1
1,Analfabeto,3184,Desenhistas Técnicos De Produtos E Serviços Diversos,1749.8760635868196,-1,18,19
1,Analfabeto,3185,Desenhistas Projetistas De Construção Civil E Arquitetura,2551.1465833155107,22,63,41
1,Analfabeto,3186,Desenhistas Projetistas Da Mecânica,3201.5809936523438,-4,19,23
1,Analfabeto,3187,Desenhistas Projetistas Da Eletrônica,4772.2845237038355,-7,2,9
1,Analfabeto,3188,Desenhistas Projetistas E Modelistas De Produtos E Serviços Diversos,2424.47441260183,9,40,31
1,Analfabeto,3191,Técnicos Do Vestuário,2018.8666585286458,-1,1,2
1,Analfabeto,3201,Técnicos Em Biologia,1156,0,1,1
1,Analfabeto,3211,Técnicos Agrícolas,4874.237754050862,1,56,55
1,Analfabeto,3212,Técnicos Florestais,1385.5895565864735,23,80,57
1,Analfabeto,3213,Técnicos Em Aqüicultura,1800,-2,1,3
1,Analfabeto,3221,Tecnólogos E Técnicos Em Terapias Complementares E Estéticas,1577.2181917441012,10,59,49
1,Analfabeto,3222,Técnicos E Auxiliares De Enfermagem,1989.1070732884125,-15,1130,1145
1,Analfabeto,3223,Técnicos Em Óptica E Optometria,1529.642857142857,4,9,5
1,Analfabeto,3224,Técnicos De Odontologia,1362.4793848200036,30,154,124
1,Analfabeto,3225,Técnicos Em Próteses Ortopédicas,1336.5,-2,1,3
1,Analfabeto,3226,Técnicos De Imobilizações Ortopédicas,2037.8612365722656,2,5,3
1,Analfabeto,3231,Técnicos Em Pecuária,1434.5999581473213,3,5,2
1,Analfabeto,3241,Tecnólogos E Técnicos Em Métodos De Diagnósticos E Terapêutica,1806.3651127979008,-15,23,38
1,Analfabeto,3242,Técnicos De Laboratórios De Saúde E Bancos De Sangue,1737.9165676743237,2,35,33
1,Analfabeto,3250,"Enólogos, Perfumistas E Aromistas",1233.385707310268,1,4,3
1,Analfabeto,3251,Técnico Em Farmácia E Em Manipulação Farmacêutica,1945.0741792862282,2,22,20
1,Analfabeto,3252,"Técnicos Em Produção, Conservação  E De Qualidade De Alimentos",2086.9023441806276,10,75,65
1,Analfabeto,3311,Professores De Nível Médio Na Educação Infantil,1919.258724138568,64,442,378
1,Analfabeto,3312,Professores De Nível Médio No Ensino Fundamental,3020.0181248754047,24,162,138
1,Analfabeto,3313,Professores De Nível Médio No Ensino Profissionalizante,1934.269305229187,-6,4,10
1,Analfabeto,3321,Professores Leigos No Ensino Fundamental,1328.0742451594426,5,16,11
1,Analfabeto,3322,Professores Práticos No Ensino Profissionalizante,2132.623321533203,-2,5,7
1,Analfabeto,3331,Instrutores E Professores De Cursos Livres,2071.205244119559,22,204,182
1,Analfabeto,3341,Inspetores De Alunos E Afins,1316.4898388312256,112,307,195
1,Analfabeto,3411,"Pilotos De Aviação Comercial, Mecânicos De Vôo E Afins",2201.080037434896,-5,0,5
1,Analfabeto,3412,"Técnicos Marítimos, Fluviários E Pescadores De Convés",1340.5056579137106,16,72,56
1,Analfabeto,3413,Técnicos Marítimos E Fluviários De Máquinas,2300.4074170679078,-9,19,28
1,Analfabeto,3421,Especialistas Em Logística De Transportes,2605.318176932253,11,189,178
1,Analfabeto,3422,Despachantes Aduaneiros,1838.3121722677479,7,50,43
1,Analfabeto,3423,Técnicos Em Transportes Rodoviários,2427.457794673281,-18,49,67
1,Analfabeto,3424,Técnicos Em Transportes Metroferroviários,1612.3954910278321,-1,6,7
1,Analfabeto,3425,Técnicos Em Transportes Aéreos,1846.5827196121215,6,37,31
1,Analfabeto,3426,Técnicos Em Transportes Por Vias Navegáveis E Operações Portuárias,3870.578578404018,-2,3,5
1,Analfabeto,3511,Técnicos Em Contabilidade,3426.0314364963106,3,21,18
1,Analfabeto,3513,Técnicos Em Administração,3400.002475733328,20,67,47
1,Analfabeto,3514,Serventuários Da Justiça E Afins,1873.3995589039212,-14,66,80
1,Analfabeto,3515,"Técnicos Em Secretariado, Taquígrafos E Estenotipistas",2958.695308383745,35,118,83
1,Analfabeto,3516,Técnicos Em Segurança Do Trabalho,3813.2352572511595,66,392,326
1,Analfabeto,3517,Técnicos De Seguros E Afins,3496.3779626076803,23,67,44
1,Analfabeto,3518,Agentes De Investigação E Identificação,3659.469970703125,-1,0,1
1,Analfabeto,3519,Técnicos Da Inteligência,7314.59521484375,-2,0,2
1,Analfabeto,3522,Agentes Da Saúde E Do Meio Ambiente,5107.614275328016,3,46,43
1,Analfabeto,3523,Agentes  Fiscais Metrológicos E De Qualidade,2916.907502092634,-8,21,29
1,Analfabeto,3532,Técnicos Em Operações E Serviços Bancários,2676.18798828125,0,3,3
1,Analfabeto,3541,Especialistas Em Promoção De Produtos E Vendas,2537.5513536577246,87,1058,971
1,Analfabeto,3542,Compradores,4396.732999475653,18,120,102
1,Analfabeto,3543,Analistas De Comércio Exterior,4589.668722534179,0,20,20
1,Analfabeto,3544,Leiloeiros E Avaliadores,2243.0595601399737,6,8,2
1,Analfabeto,3545,Corretores De Seguros,1491.3533528645833,1,2,1
1,Analfabeto,3546,Corretores De Imóveis E De Grãos,1901.3010575143915,1,10,9
1,Analfabeto,3547,Representantes Comerciais Autônomos,1625.7222222222222,2,10,8
1,Analfabeto,3548,Técnicos Em Serviços De Turismo E Organização De Eventos,1995.4344598891244,27,77,50
1,Analfabeto,3711,Técnicos Em Biblioteconomia,2897.202985797012,-3,10,13
1,Analfabeto,3713,Técnicos Em Artes Gráficas,2312.030029296875,0,1,1
1,Analfabeto,3714,Recreadores,1462.34177414438,10,128,118
1,Analfabeto,3721,Captadores De Imagens Em Movimento,3027.9795797596807,5,15,10
1,Analfabeto,3722,Operadores De Rede De Teleprocessamento E Afins,1983.289836883545,-7,15,22
1,Analfabeto,3731,Técnicos De Operação De Registros Sonoro/Audiovisuais,3002.35591506958,4,16,12
1,Analfabeto,3732,Supervisores Operacionais E Técnicos Em Mídias Audiovisuais,6972.5919738769535,-17,0,17
1,Analfabeto,3741,Técnicos Em Áudio,1567.2164614722842,-13,28,41
1,Analfabeto,3742,Técnicos Em Cenografia,1929.4777696397568,0,4,4
1,Analfabeto,3743,Técnicos Em Operação De Aparelhos De Projeção,1980,1,1,0
1,Analfabeto,3744,"Técnicos Em Montagem, Edição E Finalização De Mídia Audiovisual",2141.1920791408616,5,100,95
1,Analfabeto,3751,"Designers De Interiores, De Vitrines E Visual Merchandiser E Afins (Nível Médio)",1901.8474356192128,-3,18,21
1,Analfabeto,3761,Dançarinos Tradicionais E Populares,6459.2001953125,1,1,0
1,Analfabeto,3762,Artistas De Circo (Circenses),1484.7258199055989,-1,3,4
1,Analfabeto,3763,"Apresentadores De Eventos, Programas E Espetáculos",1743.6566569010415,0,2,2
1,Analfabeto,3771,Atletas Profissionais,2954.1755129897806,32,170,138
1,Analfabeto,3772,Árbitros Desportivos,7779.2001953125,-1,0,1
1,Analfabeto,3911,"Planejadores, Programadores E Controladores De Produção E Manutenção",3077.5625057128786,126,545,419
1,Analfabeto,3912,Técnicos De Controle Da Produção,2306.1592801512425,69,498,429
1,Analfabeto,3951,Técnicos De Apoio Em Pesquisa E Desenvolvimento,3786.104954528809,-1,26,27
1,Analfabeto,4101,Supervisores Administrativos,2934.3184690041376,-51,441,492
1,Analfabeto,4102,"Supervisores De Serviços Financeiros, De Câmbio E De Controle",4054.8234979881713,-10,109,119
1,Analfabeto,4110,"Agentes, Assistentes E Auxiliares Administrativos",1635.9468430365248,989,7654,6665
1,Analfabeto,4121,Operadores De Equipamentos De Entrada E Transmissão De Dados,1619.4494921971882,-8,49,57
1,Analfabeto,4122,Contínuos,2877.0440802966723,137,981,844
1,Analfabeto,4131,Auxiliares De Contabilidade,3218.343548944147,111,536,425
1,Analfabeto,4132,Escriturários De Serviços Bancários,1535.7347966821376,-1,84,85
1,Analfabeto,4141,Almoxarifes E Armazenistas,1790.4747168264132,880,5612,4732
1,Analfabeto,4142,Apontadores E Conferentes,1752.729666314265,-21,690,711
1,Analfabeto,4151,"Auxiliares De Serviços De Documentação, Informação E Pesquisa",2311.8439958828353,2,39,37
1,Analfabeto,4152,"Trabalhadores Nos Serviços De Classificação E Entregas De Correspondências, Encomendas E Publicações",1555.6662792207728,-9,35,44
1,Analfabeto,4201,Supervisores De Atendimento Ao Público E De Pesquisa,2083.655113877889,-12,68,80
1,Analfabeto,4211,Caixas E Bilheteiros (Exceto Caixa De Banco),1429.2512062793164,328,2868,2540
1,Analfabeto,4212,Coletadores De Apostas E De Jogos,3249.4809763838607,6,44,38
1,Analfabeto,4213,Cobradores E Afins,3454.7170300604935,34,239,205
1,Analfabeto,4221,Recepcionistas,1595.3823753551144,324,2160,1836
1,Analfabeto,4222,Operadores De Telefonia,1811.4017389437406,18,101,83
1,Analfabeto,4223,Operadores De Telemarketing E Afins,1506.5637107877965,-275,662,937
1,Analfabeto,4231,Despachantes Documentalistas E Afins,1498.1274904430422,-11,19,30
1,Analfabeto,4241,Entrevistadores E Recenseadores,1449.5813338706248,-5,29,34
1,Analfabeto,4242,Aplicadores De Provas E Afins,1100,1,1,0
1,Analfabeto,5101,"Supervisores Dos Serviços De Transporte, Turismo, Hotelaria E Administração De Edifícios",2298.957501110431,-28,84,112
1,Analfabeto,5102,Supervisores De Lavanderia,2345.791259765625,0,4,4
1,Analfabeto,5103,"Supervisores Dos Serviços De Proteção, Segurança E Outros",5218.369472857603,-2,48,50
1,Analfabeto,5111,Trabalhadores De Segurança E Atendimento Aos Usuários Nos Transportes,1296.6460809616815,-11,5,16
1,Analfabeto,5112,Fiscais E Cobradores Dos Transportes Coletivos,1669.2212834985526,-85,92,177
1,Analfabeto,5114,Guias De Turismo,1478.653340657552,4,5,1
1,Analfabeto,5115,Condutores De Turismo,1446.2366536458335,0,2,2
1,Analfabeto,5121,Trabalhadores Dos Serviços Domésticos Em Geral,1289.6012042457735,30,489,459
1,Analfabeto,5131,Mordomos E Governantas,1691.3809809894944,-6,39,45
1,Analfabeto,5132,Cozinheiros,1495.8922707542602,142,4490,4348
1,Analfabeto,5133,"Camareiros, Roupeiros E Afins",1695.4326264164777,-37,764,801
1,Analfabeto,5134,"Trabalhadores No Atendimento Em Estabelecimentos De Serviços De Alimentação, Bebidas E Hotelaria",1634.1315566748003,729,5258,4529
1,Analfabeto,5135,Trabalhadores Auxiliares Nos Serviços De Alimentação,1619.8866465872457,1082,6688,5606
1,Analfabeto,5136,"Churrasqueiros, Pizzaiolos E Sushimen",2547.6190967907146,15,308,293
1,Analfabeto,5141,Trabalhadores Nos Serviços De Administração De Edifícios,1526.3570144005237,129,2808,2679
1,Analfabeto,5142,"Trabalhadores Nos Serviços De Coleta De Resíduos, De Limpeza E Conservação De Áreas Públicas",1788.658353420515,705,8261,7556
1,Analfabeto,5143,Trabalhadores Nos  Serviços De Manutenção De Edificações,1554.6987629719151,3710,30965,27255
1,Analfabeto,5151,Trabalhadores Em Serviços De Promoção E Apoio À Saúde,1549.6129177166297,89,211,122
1,Analfabeto,5152,Auxiliares De Laboratório Da Saúde,1791.392676732688,44,204,160
1,Analfabeto,5153,"Trabalhadores De Atenção, Defesa E Proteção A Pessoas Em Situação De Risco E Adolescentes Em Conflito Com A Lei",1716.090758634532,105,220,115
1,Analfabeto,5161,Trabalhadores Nos Serviços De Embelezamento E Higiene,4406.535710729733,-31,26,57
1,Analfabeto,5162,"Cuidadores De Crianças, Jovens, Adultos E Idosos",1591.817723118162,24,284,260
1,Analfabeto,5163,"Tintureiros, Lavadeiros E Afins, A Máquina",1382.051012686433,164,1076,912
1,Analfabeto,5164,"Lavadores E Passadores De Roupa, A Mão",1340.7363373050846,-4,41,45
1,Analfabeto,5165,Trabalhadores Dos Serviços Funerários,1471.777027027027,-3,17,20
1,Analfabeto,5166,Trabalhadores Auxiliares Dos Serviços Funerários,1655.6096105441243,1,74,73
1,Analfabeto,5171,"Bombeiros, Salva-Vidas E Afins",2084.45080427498,23,127,104
1,Analfabeto,5172,"Policiais, Guardas-Civis Municipais E Agentes De Trânsito",1665.0193282323526,1,31,30
1,Analfabeto,5173,Vigilantes E Guardas De Segurança,1534.57630006919,323,2926,2603
1,Analfabeto,5174,"Porteiros, Vigias E Afins",1596.1074324188683,-600,5718,6318
1,Analfabeto,5191,Motociclistas E Ciclistas De Entregas Rápidas,1481.3266611327954,73,457,384
1,Analfabeto,5192,Trabalhadores Da Coleta E Seleção De Material Reciclável,2745.20410315104,51,432,381
1,Analfabeto,5193,"Trabalhadores De Serviços Veterinários, De Higiene E Estética De Animais Domésticos",1457.648006466217,56,184,128
1,Analfabeto,5199,Outros Trabalhadores Dos Serviços,2083.527492677823,78,1052,974
1,Analfabeto,5201,Supervisores De Vendas E De Prestação De Serviços,2295.5623281407616,1,166,165
1,Analfabeto,5211,Operadores Do Comércio Em Lojas E Mercados,1604.7180168044547,1519,13542,12023
1,Analfabeto,5231,Instaladores De Produtos E Acessórios,1594.3385611285398,-16,61,77
1,Analfabeto,5241,Vendedores Em Domicílio,1389.5226025371433,-7,235,242
1,Analfabeto,5242,"Vendedores Em Bancas, Quiosques E Barracas",1294.1205234625402,-8,26,34
1,Analfabeto,5243,Vendedores Ambulantes,1086.9022491455078,0,20,20
1,Analfabeto,6110,Produtores Agropecuários Em Geral,1230.0036999678928,9,114,105
1,Analfabeto,6120,Produtores Agrícolas Polivalentes,1361.0558994391026,7,101,94
1,Analfabeto,6121,Produtores Agrícolas Na Cultura De Gramíneas,1254.3319986979166,7,31,24
1,Analfabeto,6123,Produtores Agrícolas Na Olericultura,1401.172231401716,-6,8,14
1,Analfabeto,6124,Produtores Agrícolas No Cultivo De Flores E Plantas Ornamentais,1499.4166666666667,2,5,3
1,Analfabeto,6125,Produtores Agrícolas Na Fruticultura,1048.3971206202652,2,15,13
1,Analfabeto,6126,Produtores Agrícolas Na Cultura De Plantas Estimulantes,1169.5409912109376,-1,3,4
1,Analfabeto,6127,Produtores Agrícolas Na Cultura De Plantas Oleaginosas,998,-2,0,2
1,Analfabeto,6128,Produtores De Especiarias E De Plantas Aromáticas E Medicinais,1446,0,1,1
1,Analfabeto,6130,Produtores Em Pecuária Polivalente,1392.6478415096508,10,15,5
1,Analfabeto,6131,Produtores Em Pecuária De Animais De Grande Porte,1373.2098379426498,1,44,43
1,Analfabeto,6132,Produtores Em Pecuária De Animais De Médio Porte,1440.835710797991,0,12,12
1,Analfabeto,6133,Produtores Da Avicultura E Cunicultura,1402.9468686888818,-5,72,77
1,Analfabeto,6134,Produtores De Animais E Insetos Úteis,1603.2083333333335,1,3,2
1,Analfabeto,6201,Supervisores Na Exploração Agropecuária,2425.7971899069144,-33,413,446
1,Analfabeto,6210,Trabalhadores Agropecuários Em Geral,2174.705100984251,-561,19024,19585
1,Analfabeto,6220,Trabalhadores De Apoio À Agricultura,1921.4158535441952,646,18442,17796
1,Analfabeto,6221,Trabalhadores Agrícolas Na Cultura De Gramíneas,1621.2132501633073,-1691,58805,60496
1,Analfabeto,6222,Trabalhadores Agrícolas Na Cultura De Plantas Fibrosas,1400.8785035223023,0,63,63
1,Analfabeto,6223,Trabalhadores Agrícolas Na Olericultura,1289.5882430154247,-3,594,597
1,Analfabeto,6224,Trabalhadores Agrícolas No Cultivo De Flores E Plantas Ornamentais,1366.341755378753,-45,332,377
1,Analfabeto,6225,Trabalhadores Agrícolas Na Fruticultura,1723.298960776786,269,15496,15227
1,Analfabeto,6226,Trabalhadores Agrícolas Nas Culturas De Plantas Estimulantes,1398.4151503230705,-81,4261,4342
1,Analfabeto,6227,Trabalhadores Agrícolas Na Cultura De Plantas Oleaginosas,1361.4318899821803,248,1507,1259
1,Analfabeto,6228,Trabalhadores Agrícolas Da Cultura De Especiarias E De Plantas Aromáticas E Medicinais,959.9974259437598,5,73,68
1,Analfabeto,6230,Tratadores Polivalentes De Animais,1647.1801737268208,71,1628,1557
1,Analfabeto,6231,Trabalhadores Na Pecuária De Animais De Grande Porte,1421.0141114403439,-335,6908,7243
1,Analfabeto,6232,Trabalhadores Na Pecuária De Animais De Médio Porte,1408.255748190468,28,432,404
1,Analfabeto,6233,Trabalhadores Na Avicultura E Cunicultura,1482.0797170427331,186,2185,1999
1,Analfabeto,6234,Trabalhadores Na Criação De Insetos E Animais Úteis,1372.2642465961474,3,23,20
1,Analfabeto,6301,Supervisores Na Área Florestal E Aqüicultura,1879.8603291829427,-1,22,23
1,Analfabeto,6310,Pescadores Polivalentes,1201.4196107153798,-1,25,26
1,Analfabeto,6311,Pescadores Profissionais Artesanais De Água Doce,377.0254825957834,13,43,30
1,Analfabeto,6312,Pescadores De Água Costeira E Alto Mar,1522.5950531640642,-15,374,389
1,Analfabeto,6313,Criadores De Animais Aquáticos,1398.5259638981115,40,237,197
1,Analfabeto,6314,Trabalhadores De Apoio À Pesca,1299.2854471756964,-4,40,44
1,Analfabeto,6320,Trabalhadores Florestais Polivalentes,1496.4644762560413,15,68,53
1,Analfabeto,6321,Extrativistas E Reflorestadores De Espécies Produtoras De Madeira,1449.8717015297652,224,4468,4244
1,Analfabeto,6322,Extrativistas Florestais De Espécies Produtoras De Gomas E Resinas,1197.8264640304578,-41,189,230
1,Analfabeto,6323,"Extrativistas Florestais De Espécies Produtoras De Fibras, Ceras E Óleos",1734.2431195009967,-9,654,663
1,Analfabeto,6324,Extrativistas Florestais De Espécies Produtoras De Alimentos Silvestres,1265.921172187046,-7,56,63
1,Analfabeto,6325,"Extrativistas Florestais De Espécies Produtoras De Substâncias Aromáticas, Medicinais E Tóxicas",1346.7857145440641,-7,24,31
1,Analfabeto,6326,Carvoejadores,1285.1195767895927,73,1204,1131
1,Analfabeto,6410,Trabalhadores Da Mecanização Agrícola,5075.008684441692,-4,3476,3480
1,Analfabeto,6420,Trabalhadores Da Mecanização Florestal,1868.444988307696,12,269,257
1,Analfabeto,6430,Trabalhadores Da Irrigação E Drenagem,1550.0677261644144,-14,119,133
1,Analfabeto,7101,Supervisores Da Extração Mineral,2558.2662699645734,-7,10,17
1,Analfabeto,7102,Supervisores Da Construção Civil,2802.0469663662498,-25,769,794
1,Analfabeto,7111,Trabalhadores Da Extração De Minerais Sólidos,1562.5657837137026,5,197,192
1,Analfabeto,7112,Trabalhadores De Extração De Minerais Sólidos (Operadores De Máquinas),1975.7360715105356,7,429,422
1,Analfabeto,7113,Trabalhadores Da Extração De Minerais Líquidos E Gasosos,4378.110390004541,14,195,181
1,Analfabeto,7114,Garimpeiros E Operadores De Salinas,1448.988334019979,10,27,17
1,Analfabeto,7121,Trabalhadores De Beneficiamento De Minérios,3225.437573465675,-15,104,119
1,Analfabeto,7122,Trabalhadores De Beneficiamento De Pedras Ornamentais,2127.753573810662,-16,162,178
1,Analfabeto,7151,Trabalhadores Na Operação De Máquinas De Terraplenagem E Fundações,2106.333224637985,112,1678,1566
1,Analfabeto,7152,Trabalhadores De Estruturas De Alvenaria,2484.8647160716423,528,10936,10408
1,Analfabeto,7153,Montadores De Estruturas De Concreto Armado,2215.359612029921,65,1690,1625
1,Analfabeto,7154,Trabalhadores Na Operação De Máquinas De Concreto Usinado E Afins,1987.3385375730036,-72,373,445
1,Analfabeto,7155,"Trabalhadores De Montagem De Estruturas De Madeira, Metal E Compósitos Em Obras Civis",2092.9078758106716,67,3655,3588
1,Analfabeto,7156,Trabalhadores De Instalações Elétricas,7685.978478859502,-39,742,781
1,Analfabeto,7157,Aplicadores De Materiais Isolantes,6531.219308021704,33,187,154
1,Analfabeto,7161,Revestidores De Concreto,1758.3272470057696,-14,52,66
1,Analfabeto,7162,Telhadores (Revestimentos Rígidos),1556.3360457152592,1,22,21
1,Analfabeto,7163,Vidraceiros (Revestimentos Rígidos),1586.3352320380982,-9,123,132
1,Analfabeto,7164,Gesseiros,1760.0721035073188,15,419,404
1,Analfabeto,7165,"Aplicadores De Revestimentos Cerâmicos, Pastilhas, Pedras E Madeiras",1683.256067318359,51,315,264
1,Analfabeto,7166,Pintores De Obras E Revestidores De Interiores (Revestimentos Flexíveis),1553.8092916754752,-8,958,966
1,Analfabeto,7170,Ajudantes De Obras Civis,1687.0201072696877,1782,30490,28708
1,Analfabeto,7201,"Supervisores De Usinagem, Conformação E Tratamento De Metais",3288.979415241625,-11,35,46
1,Analfabeto,7202,Supervisores Da Fabricação E Montagem Metalmecânica,4753.488247664517,-9,9,18
1,Analfabeto,7211,Ferramenteiros E Afins,2058.3662943959666,6,37,31
1,Analfabeto,7212,Preparadores E Operadores De Máquinas-Ferramenta Convencionais,5517.2009742261735,15,454,439
1,Analfabeto,7213,Afiadores E Polidores De Metais,1528.8148599133285,-11,97,108
1,Analfabeto,7214,Operadores De Máquinas De Usinagem Cnc,2594.712844125519,-4,61,65
1,Analfabeto,7221,Trabalhadores De Forjamento De Metais,4322.992796775411,-3,91,94
1,Analfabeto,7222,Trabalhadores De Fundição De Metais Puros E De Ligas Metálicas,1741.6780999257987,0,213,213
1,Analfabeto,7223,Trabalhadores De Moldagem De Metais E De Ligas Metálicas,1699.7695017847263,2,99,97
1,Analfabeto,7224,Trabalhadores De Trefilação E Estiramento De Metais Puros E Ligas Metálicas,1760.5407021262429,-4,11,15
1,Analfabeto,7231,Trabalhadores De Tratamento Térmico De Metais,2276.0013292100693,3,11,8
1,Analfabeto,7232,Trabalhadores De Tratamento De Superfícies De Metais E De Compósitos (Termoquímicos),1949.2611008321223,-18,53,71
1,Analfabeto,7233,"Trabalhadores Da Pintura De Equipamentos, Veículos, Estruturas Metálicas E De Compósitos",1707.5606350462447,-7,386,393
1,Analfabeto,7241,Encanadores E Instaladores De Tubulações,2523.356098116075,-8,853,861
1,Analfabeto,7242,Trabalhadores De Traçagem E Montagem De Estruturas Metálicas E De Compósitos,2364.176885023416,46,1272,1226
1,Analfabeto,7243,Trabalhadores De Soldagem E Corte De Ligas Metálicas,2499.01928299623,45,1100,1055
1,Analfabeto,7244,Trabalhadores De Caldeiraria E Serralheria,2492.0412792043935,100,856,756
1,Analfabeto,7245,Operadores De Máquinas De Conformação De Metais,2362.664362932763,-44,131,175
1,Analfabeto,7246,Trançadores E Laceiros De Cabos De Aço,2725,2,2,0
1,Analfabeto,7250,Ajustadores Mecânicos Polivalentes E Afins,5402.846201150072,11,118,107
1,Analfabeto,7251,"Montadores De Máquinas, Aparelhos E Acessórios Em Linhas De Montagem",1638.8690397433745,14,163,149
1,Analfabeto,7252,Montadores De Máquinas Industriais,2038.3797890871683,-22,207,229
1,Analfabeto,7253,Montadores De Máquinas Pesadas E Equipamentos Agrícolas,1918.9375429258243,34,73,39
1,Analfabeto,7254,Mecânicos Montadores De Motores E Turboalimentadores,2483.6244916717937,-5,9,14
1,Analfabeto,7255,Montadores De Veículos Automotores (Linha De Montagem),2568.3088501922844,-15,37,52
1,Analfabeto,7256,Montadores De Sistemas E Estruturas De Aeronaves,2154.22998046875,1,1,0
1,Analfabeto,7257,Instaladores De Equipamentos De Refrigeração E Ventilação,1960.5892665211747,0,41,41
1,Analfabeto,7301,Supervisores De Montagens E Instalações Eletroeletrônicas,4258.873887803819,-4,7,11
1,Analfabeto,7311,Montadores De Equipamentos Eletroeletrônicos,4074.5014625888357,16,474,458
1,Analfabeto,7312,Montadores De Aparelhos De Telecomunicações,1319.6553861177886,-1,6,7
1,Analfabeto,7313,Instaladores-Reparadores De  Linhas E Equipamentos De Telecomunicações,1442.3093906795111,13,93,80
1,Analfabeto,7321,"Instaladores E Reparadores De Linhas E Cabos Elétricos, Telefônicos E De Comunicação De Dados",1586.4455973047127,808,1326,518
1,Analfabeto,7401,Supervisores Da Mecânica De Precisão E Instrumentos Musicais,4000,0,1,1
1,Analfabeto,7411,Mecânicos De Instrumentos De Precisão,1924.7461157226564,-3,15,18
1,Analfabeto,7421,Confeccionadores De Instrumentos Musicais,1604.0775146484375,1,2,1
1,Analfabeto,7502,"Supervisores De Vidraria, Cerâmica E Afins",2670,-1,0,1
1,Analfabeto,7510,Joalheiros E Lapidadores De Gemas,1537,-1,1,2
1,Analfabeto,7511,Artesãos De Metais Preciosos E Semi-Preciosos,1226.2863200338263,-3,9,12
1,Analfabeto,7521,"Sopradores, Moldadores E Modeladores De Vidros E Afins",1436.532918294271,-4,2,6
1,Analfabeto,7522,Trabalhadores Da Transformação De Vidros Planos,1626.8353054470485,4,20,16
1,Analfabeto,7523,Ceramistas (Preparação E Fabricação),1408.9098816237001,42,446,404
1,Analfabeto,7524,Vidreiros E Ceramistas (Arte E Decoração),1653.1605498342803,0,12,12
1,Analfabeto,7601,Supervisores Da Indústria Têxtil,1601.6121625366209,16,51,35
1,Analfabeto,7603,Supervisores Na Confecção Do Vestuário,2474.670565359933,-6,17,23
1,Analfabeto,7604,Supervisores Na Confecção De Calçados,3584.4213270399305,1,23,22
1,Analfabeto,7605,"Supervisores Da Confecção De Artefatos De Tecidos, Couros E Afins",3766.6728166852677,3,5,2
1,Analfabeto,7606,Supervisores Das Artes Gráficas,15978.599609375,-1,0,1
1,Analfabeto,7610,Trabalhadores Polivalentes Das Indústrias Têxteis,1186.6514387667814,144,729,585
1,Analfabeto,7611,Trabalhadores Da Classificação De Fibras Têxteis E Lavagem De Lã,1983.3050537109375,-2,0,2
1,Analfabeto,7612,Operadores Da Fiação,1523.9813924880254,7,53,46
1,Analfabeto,7613,Operadores De Tear E Máquinas Similares,1778.9863260249576,4,147,143
1,Analfabeto,7614,"Trabalhadores De Acabamento, Tingimento E Estamparia Das Indústrias Têxteis",2223.328123002238,-17,87,104
1,Analfabeto,7618,Inspetores E Revisores De Produção Têxtil,1580.6437849757515,-8,165,173
1,Analfabeto,7620,Trabalhadores Polivalentes Do Curtimento De Couros E Peles,1416.3125263875845,-1,122,123
1,Analfabeto,7621,Trabalhadores Da Preparação Do Curtimento De Couros E Peles,1362.6665087890626,-9,10,19
1,Analfabeto,7622,Trabalhadores Do Curtimento De Couros E Peles,1762.0280299168007,-6,29,35
1,Analfabeto,7623,Trabalhadores Do Acabamento De Couros E Peles,1523.9181461879186,-18,44,62
1,Analfabeto,7630,Profissionais Polivalentes Da Confecção De Roupas,1396.4845243759653,-48,138,186
1,Analfabeto,7631,Trabalhadores Da Preparação Da Confecção De Roupas,1467.4658115177886,76,777,701
1,Analfabeto,7632,Operadores De Máquinas Para Costura De Peças Do Vestuário,1365.6810053215029,-84,1513,1597
1,Analfabeto,7633,Operadores De Máquinas Para Bordado E Acabamento De Roupas,1435.5255845841123,56,389,333
1,Analfabeto,7640,Trabalhadores Polivalentes Da Confecção De Calçados,1305.0919911802027,194,659,465
1,Analfabeto,7641,Trabalhadores Da Preparação Da Confecção De Calçados,1422.8860643726775,230,657,427
1,Analfabeto,7642,Operadores De Máquinas De Costurar E Montar Calçados,1505.2021217477504,-30,96,126
1,Analfabeto,7643,Trabalhadores De Acabamento De Calçados,1514.868317561363,36,152,116
1,Analfabeto,7650,Trabalhadores Polivalentes Da Confecção De Artefatos De Tecidos E Couros,1283.3460344587054,9,19,10
1,Analfabeto,7651,"Trabalhadores Da Preparação De Artefatos De Tecidos, Couros E Tapeçaria",1318.2698059078307,-1,10,11
1,Analfabeto,7652,"Trabalhadores Da Confecção De Artefatos De Tecidos, Couros E Sintéticos",1529.9649463926833,-25,77,102
1,Analfabeto,7653,Operadores De Máquinas Na Confecção De Artefatos De  Couro,1414.4196041046625,1,13,12
1,Analfabeto,7654,Trabalhadores Do Acabamento De Artefatos De Tecidos E Couros,1333.7364462575604,-1,15,16
1,Analfabeto,7661,Trabalhadores Da Pré-Impressão Gráfica,1912.3113774355572,-8,35,43
1,Analfabeto,7662,Trabalhadores Da Impressão Gráfica,1895.3879767477204,4,90,86
1,Analfabeto,7663,Trabalhadores Do Acabamento Gráfico,1970.592935144258,20,150,130
1,Analfabeto,7664,Trabalhadores De Laboratório Fotográfico E Radiológico,1482.3500162760417,-2,1,3
1,Analfabeto,7681,"Trabalhadores De Tecelagem Manual, Tricô, Crochê, Rendas E Afins",1841.0907545823318,-3,6,9
1,Analfabeto,7682,Trabalhadores Artesanais Da Confecção De Peças E Tecidos,1518.5391642252605,2,7,5
1,Analfabeto,7683,Trabalhadores Artesanais Da Confecção De Calçados E Artefatos De Couros E Peles,1693.5653106424083,63,160,97
1,Analfabeto,7686,Trabalhadores Tipográficos Linotipistas E Afins,1185.9504536330098,36,117,81
1,Analfabeto,7701,"Supervisores Em Indústria De Madeira, Mobiliário E Da Carpintaria Veicular",2945.477520942688,2,57,55
1,Analfabeto,7711,Marceneiros E Afins,1574.2200614302837,-22,390,412
1,Analfabeto,7721,Trabalhadores De Tratamento E Preparação Da Madeira,1454.083579231162,-45,352,397
1,Analfabeto,7731,Operadores De Máquinas De Desdobramento Da Madeira,2049.7437534803644,-73,483,556
1,Analfabeto,7732,Operadores De Máquinas De Aglomeração E Prensagem De Chapas,1514.5193786621094,1,15,14
1,Analfabeto,7733,Operadores De Usinagem Convencional De Madeira,1607.7394828499494,-61,227,288
1,Analfabeto,7734,Operadores De Máquina De Usinar Madeira (Produção Em Série),13063.070508914523,-5,28,33
1,Analfabeto,7735,Operadores De Máquinas De Usinagem De Madeira Cnc,2228.9822518484934,-3,5,8
1,Analfabeto,7741,Montadores De Móveis E Artefatos De Madeira,1505.6024810840834,-32,252,284
1,Analfabeto,7751,Trabalhadores De Arte E  Do Acabamento Em Madeira Do Mobiliário,1435.8429284737472,-6,35,41
1,Analfabeto,7764,"Confeccionadores De Artefatos De Madeira, Móveis De Vime E Afins",1599.429327392578,-2,12,14
1,Analfabeto,7771,Carpinteiros Navais,2411.3333129882813,-1,2,3
1,Analfabeto,7772,Carpinteiros De Carrocerias E Carretas,2169.9616902669272,2,4,2
1,Analfabeto,7801,Supervisores De Trabalhadores De Embalagem E Etiquetagem,1767.8174858093262,-4,14,18
1,Analfabeto,7811,Condutores De Processos Robotizados,1963.2150268554688,2,5,3
1,Analfabeto,7813,Operadores De Equipamentos Pilotados Remotamente,1545.1099853515625,1,1,0
1,Analfabeto,7817,Trabalhadores Subaquáticos,1751.800048828125,1,1,0
1,Analfabeto,7821,Operadores De Máquinas E Equipamentos De Elevação,3664.779400907884,-6,285,291
1,Analfabeto,7822,Operadores De Equipamentos De Movimentação De Cargas,1674.8217378738402,-42,584,626
1,Analfabeto,7823,Motoristas De Veículos De Pequeno E Médio Porte,1811.9166220323646,111,1221,1110
1,Analfabeto,7824,"Motoristas De Ônibus Urbanos, Metropolitanos E Rodoviários",2643.4869497498607,109,715,606
1,Analfabeto,7825,Motoristas De Veículos De Cargas Em Geral,2271.6884805833815,335,3971,3636
1,Analfabeto,7826,Operadores De Veículos Sobre Trilhos E Cabos Aéreos,2190.785993787977,2,10,8
1,Analfabeto,7827,Trabalhadores Aquaviários,1665.7525420605004,15,89,74
1,Analfabeto,7828,Condutores De Animais E De Veículos De Tração Animal E Pedais,1373.324272571076,8,77,69
1,Analfabeto,7831,Trabalhadores De Manobras De Transportes Sobre Trilhos,1497.1300771384113,45,111,66
1,Analfabeto,7832,Trabalhadores De Cargas E Descargas De Mercadorias,1923.518211936518,585,6574,5989
1,Analfabeto,7841,Trabalhadores De Embalagem E De Etiquetagem,1859.7778679319995,46,1800,1754
1,Analfabeto,7842,Alimentadores De Linhas De Produção,1755.7291697859916,1398,16301,14903
1,Analfabeto,7911,Artesãos,1403.874713396341,6,15,9
1,Analfabeto,8101,"Supervisores De Produção Em Indústrias Químicas, Petroquímicas E Afins",4296.137477329799,20,26,6
1,Analfabeto,8102,Supervisores De Produção Em Indústrias De Transformação De Plásticos E Borrachas,4163.218540736607,1,4,3
1,Analfabeto,8103,"Supervisores De Produção Em Indústrias De Produtos Farmacêuticos, Cosméticos E Afins",1575,-1,0,1
1,Analfabeto,8110,"Operadores Polivalentes De Equipamentos Em Indústrias Químicas, Petroquímicas E Afins",1957.8755235548142,1,13,12
1,Analfabeto,8111,Operadores De Equipamentos De Moagem E Mistura De Materiais (Tratamentos Químicos E Afins),1688.999718309653,-12,39,51
1,Analfabeto,8112,Operadores De Calcinação E De Tratamentos Químicos De Materiais Radioativos,1399.0459821428572,-1,17,18
1,Analfabeto,8113,Operadores De Equipamentos De Filtragem E Separação,1965.887964101938,-6,9,15
1,Analfabeto,8114,"Operadores De Equipamentos De Destilação, Evaporação E Reação",2274.7354676828445,3,36,33
1,Analfabeto,8115,Operadores De Equipamentos De Produção E Refino De Petróleo E Gás,2657.1800231933594,0,1,1
1,Analfabeto,8116,Operadores De Equipamentos De Coqueificação,2728.6016642252603,2,4,2
1,Analfabeto,8117,"Operadores De Instalações E Máquinas De Produtos Plásticos, De Borracha E Moldadores De Parafinas",1476.9896536370545,-11,237,248
1,Analfabeto,8118,"Operadores De Máquinas E Instalações De Produtos Farmacêuticos, Cosméticos E Afins",1703.58235026427,3,32,29
1,Analfabeto,8121,Trabalhadores Da Fabricação De Munição E Explosivos Químicos,1363.2228139241538,1,16,15
1,Analfabeto,8131,"Operadores De Processos Das Indústrias De Transformação De Produtos Químicos, Petroquímicos E Afins",1895.853694178398,0,231,231
1,Analfabeto,8181,Laboratoristas Industriais Auxiliares,3717.600773556578,8,60,52
1,Analfabeto,8201,Supervisores De Produção Em Indústrias Siderúrgicas,4971.433349609375,-1,3,4
1,Analfabeto,8202,Supervisores Na Fabricação De Materiais Para Construção (Vidros E Cerâmicas),5123.190808747944,4,12,8
1,Analfabeto,8211,Operadores De Instalações De Sinterização,1576.3566691080728,-4,13,17
1,Analfabeto,8212,Operadores De Fornos De Primeira  Fusão E Aciaria,1654.7768861434179,41,292,251
1,Analfabeto,8213,Operadores De Equipamentos De Laminação,1597.7248943219868,-1,36,37
1,Analfabeto,8214,Operadores De Equipamentos De Acabamento De Chapas E Metais,1732.6430364158114,64,445,381
1,Analfabeto,8221,Forneiros Metalúrgicos (Segunda Fusão E Reaquecimento),1413.7981061662947,9,53,44
1,Analfabeto,8231,"Operadores Na Preparação De Massas Para Abrasivo, Vidro, Cerâmica, Porcelana E Materiais De Construção",2144.4031723257212,-10,6,16
1,Analfabeto,8232,"Operadores De Equipamentos De Fabricação  E Beneficiamento De Cristais, Vidros, Cerâmicas, Porcelanas, Fibras De Vidro, Abrasivos E Afins",1996.7929971292717,2,33,31
1,Analfabeto,8233,Operadores De Instalações E Equipamentos De Fabricação De Materiais De Construção,1366.6310114828873,68,845,777
1,Analfabeto,8281,Trabalhadores Da Fabricação De Cerâmica Estrutural Para Construção,2431.74921535331,-76,1070,1146
1,Analfabeto,8301,Supervisores Da Fabricação De Celulose E Papel,3594.335009765625,0,5,5
1,Analfabeto,8311,Preparadores De Pasta Para Fabricação De Papel,1432.8650666065705,1,14,13
1,Analfabeto,8321,Operadores De Máquinas De Fabricar Papel E Papelão,1705.9870215833141,-8,27,35
1,Analfabeto,8331,Operadores De Máquinas Na Fabricação De Produtos De Papel E Papelão,1609.0858378149437,-9,47,56
1,Analfabeto,8332,Trabalhadores Artesanais De Produtos De Papel E Papelão,1516.5309226296165,14,18,4
1,Analfabeto,8401,"Supervisores Da Fabricação De Alimentos, Bebidas E Fumo",3355.228428518679,6,42,36
1,Analfabeto,8411,"Trabalhadores Da Indústria De Beneficiamento De Grãos, Cereais E Afins",12650.999640713499,-17,81,98
1,Analfabeto,8412,Trabalhadores No Beneficiamento Do Sal,824.3045568817663,-4,22,26
1,Analfabeto,8413,Trabalhadores Na Fabricação E Refino De Açúcar,1579.3075067557543,-7,71,78
1,Analfabeto,8414,Trabalhadores Na Fabricação E Conservação De Alimentos,1621.5109591245316,-21,847,868
1,Analfabeto,8415,Trabalhadores Na Pasteurização Do Leite E Na Fabricação De Laticínios  E Afins,1495.6374207339773,-29,177,206
1,Analfabeto,8416,"Trabalhadores Na Industrialização De Café, Cacau, Mate E De Produtos Afins",1537.7454264322917,-2,10,12
1,Analfabeto,8417,"Trabalhadores Na Fabricação De Cachaça, Cerveja, Vinhos E Outras Bebidas",2105.3081740242596,8,83,75
1,Analfabeto,8418,"Operadores De Equipamentos Na Fabricação De Pães, Massas Alimentícias, Doces, Chocolates E Achocolatados",1464.109685524708,-24,135,159
1,Analfabeto,8421,Cigarreiros E Beneficiadores De Fumo,1404.1618910864747,38,552,514
1,Analfabeto,8422,Charuteiros,1100,1,1,0
1,Analfabeto,8481,Trabalhadores Artesanais Na Conservação De Alimentos,1624.366340906703,25,181,156
1,Analfabeto,8482,Trabalhadores Artesanais Na Pasteurização Do Leite E Na Fabricação De Laticínios E Afins,1494.5107619512648,-19,30,49
1,Analfabeto,8483,"Padeiros, Confeiteiros E Afins",1599.846941474666,-59,803,862
1,Analfabeto,8484,Trabalhadores Na Degustação E Classificação De Grãos E Afins,1800.6818861897787,-4,26,30
1,Analfabeto,8485,Magarefes E Afins,1594.3022940403519,7802,23588,15786
1,Analfabeto,8486,Trabalhadores Artesanais Na Indústria Do Fumo,1293.4962586805555,-3,111,114
1,Analfabeto,8601,Supervisores Da Produção De Utilidades,3321.869188096788,-22,13,35
1,Analfabeto,8611,"Operadores De Instalações De Geração E Distribuição De Energia Elétrica, Hidráulica, Térmica Ou Nuclear",2559.984159342448,-19,2,21
1,Analfabeto,8612,Operadores De Instalações De Distribuição De Energia Elétrica,2562.9666544596353,-2,2,4
1,Analfabeto,8621,Operadores De Máquinas A Vapor E Utilidades,8837.931575554268,0,813,813
1,Analfabeto,8622,"Operadores De Instalações De Captação, Tratamento E Distribuição De Água",1636.7158037350503,37,59,22
1,Analfabeto,8623,Operadores De Instalações De Captação E Esgotos,1522.109166071965,9,83,74
1,Analfabeto,8624,"Operadores De Instalações De Extração, Processamento, Envasamento E Distribuição De Gases",1647.7133382161458,4,5,1
1,Analfabeto,8625,Operadores De Instalações De Refrigeração E Ar-Condicionado,1587.086786114728,4,19,15
1,Analfabeto,9101,"Supervisores Em Serviços De Reparação E Manutenção De Máquinas E Equipamentos Industriais, Comerciais E Residenciais",3645.613167210629,-7,42,49
1,Analfabeto,9102,Supervisores Em Serviços De Reparação E Manutenção Veicular,3012.6670609731523,0,8,8
1,Analfabeto,9109,"Supervisores De Outros Trabalhadores De Serviços De Reparação, Conservação E Manutenção",3584.4441579182944,-1,6,7
1,Analfabeto,9111,"Mecânicos De Manutenção De Bombas, Motores, Compressores E Equipamentos De Transmissão",1893.0837617192403,-1,60,61
1,Analfabeto,9112,Mecânicos De Manutenção E Instalação De Aparelhos De  Climatização E Refrigeração,3709.108304869454,34,123,89
1,Analfabeto,9113,Mecânicos De Manutenção De Máquinas Industriais,2368.530886571414,98,863,765
1,Analfabeto,9131,Mecânicos De Manutenção De Máquinas Pesadas E Equipamentos Agrícolas,2431.6948222469355,30,159,129
1,Analfabeto,9141,Mecânicos De Manutenção Aeronáutica,2030.4000053405762,-2,9,11
1,Analfabeto,9142,Mecânicos De Manutenção De Motores E Equipamentos Navais,2597.2066243489585,1,2,1
1,Analfabeto,9143,Mecânicos De Manutenção Metroferroviária,1543.5086218877273,-4,20,24
1,Analfabeto,9144,Mecânicos De Manutenção De Veículos Automotores,1804.2999400565925,177,946,769
1,Analfabeto,9151,Técnicos Em Manutenção E Reparação De Instrumentos De Medição E Precisão,2280.8392333984375,3,8,5
1,Analfabeto,9152,Restauradores De Instrumentos Musicais,1400,1,1,0
1,Analfabeto,9153,Técnicos Em Manutenção E Reparação De Equipamentos Biomédicos,2464.1422254774307,1,5,4
1,Analfabeto,9191,Lubrificadores,1776.6165054431588,-11,87,98
1,Analfabeto,9192,"Trabalhadores De Manutenção De Roçadeiras, Motoserras E Similares",1916.4845106942314,1,113,112
1,Analfabeto,9193,Mecânicos De Manutenção De Bicicletas E Equipamentos Esportivos E De Ginástica,1410.0152149309404,-8,39,47
1,Analfabeto,9501,"Supervisores De Manutenção Eletroeletrônica Industrial, Comercial E Predial",2968.908089607913,-3,38,41
1,Analfabeto,9502,Supervisores De Manutenção Eletroeletrônica Veicular,2191.9733072916665,-1,1,2
1,Analfabeto,9503,Supervisores De Manutenção Eletromecânica,4254.587276574337,-1,16,17
1,Analfabeto,9511,Eletricistas De Manutenção Eletroeletrônica,2259.667622017825,15,344,329
1,Analfabeto,9513,Instaladores E Mantenedores De Sistemas Eletroeletrônicos De Segurança,2774.5696387181547,-5,145,150
1,Analfabeto,9531,"Eletricistas Eletrônicos De Manutenção Veicular (Aérea, Terrestre E Naval)",2121.4061807947837,0,64,64
1,Analfabeto,9541,"Instaladores E Mantenedores Eletromecânicos De Elevadores, Escadas E Portas Automáticas",2073.5671266350632,-9,54,63
1,Analfabeto,9542,Reparadores De Aparelhos Eletrodomésticos,1488.2209028764205,1,6,5
1,Analfabeto,9543,Reparadores De Equipamentos De Escritório,1662.6516520182292,2,4,2
1,Analfabeto,9911,Conservadores De Vias Permanentes (Trilhos),1859.711477032607,32,159,127
1,Analfabeto,9912,Mantenedores De Equipamentos De Parques De Diversões E Similares,1454.952001953125,-3,6,9
1,Analfabeto,9913,Reparadores De Carrocerias De Veículos,1777.3955018117147,-20,135,155
1,Analfabeto,9921,Trabalhadores Elementares De Serviços De Manutenção Veicular,1956.5452247447267,-10,342,352
1,Analfabeto,9922,Trabalhadores Operacionais De Conservação De Vias Permanentes (Exceto Trilhos),3312.3427083906377,235,2392,2157
2,Até 5ª Incompleto,0000,Não especificado,1273.4868681595622,115,228,113
2,Até 5ª Incompleto,0101,Oficiais Generais Das Forças Armadas,1371.3585295177643,13,28,15
2,Até 5ª Incompleto,0102,Oficiais Das Forças Armadas,1494.9425048828125,4,7,3
2,Até 5ª Incompleto,0103,Praças Das Forças Armadas,1383.9052010995372,-2,5,7
2,Até 5ª Incompleto,0301,Oficiais Superiores Do Corpo De Bombeiros Militar,1102,1,1,0
2,Até 5ª Incompleto,0303,Tenentes Do Corpo De Bombeiros Militar,1826.3299560546875,0,2,2
2,Até 5ª Incompleto,0311,Subtenentes E Sargentos Do Corpo De Bombeiros Militar,1320,0,1,1
2,Até 5ª Incompleto,0312,Cabos E Soldados Do Corpo De Bombeiros Militar,1223.75,1,2,1
2,Até 5ª Incompleto,1111,Legisladores,1949.8620885213218,1,8,7
2,Até 5ª Incompleto,1112,Dirigentes Gerais Da Administração Pública,2389.27567838033,-6,9,15
2,Até 5ª Incompleto,1113,Magistrados,3200,2,2,0
2,Até 5ª Incompleto,1114,Dirigentes Do Serviço Público,1268.751959298671,35,91,56
2,Até 5ª Incompleto,1115,Gestores Públicos,6261.340026855469,1,2,1
2,Até 5ª Incompleto,1130,"Dirigentes De Povos Indígenas, De Quilombolas E Caiçaras",1558.3199462890625,0,1,1
2,Até 5ª Incompleto,1142,Dirigentes E Administradores De Entidades Patronais E Dos Trabalhadores E De Outros Interesses Sócioeconômicos,5742.663886437049,-3,5,8
2,Até 5ª Incompleto,1143,Dirigentes E Administradores De Entidades Religiosas,1650,1,1,0
2,Até 5ª Incompleto,1144,Dirigentes E Administradores De Organizações Da Sociedade Civil Sem Fins Lucrativos,1555.6666666666667,-1,1,2
2,Até 5ª Incompleto,1210,Diretores Gerais,2121.8938276053655,7,143,136
2,Até 5ª Incompleto,1221,"Diretores De Produção E Operações Em Empresa Agropecuária, Pesqueira , Aqüícola E Florestal",229125.81855119977,-4,6,10
2,Até 5ª Incompleto,1222,"Diretores De Produção E Operações Em Empresa Da Indústria Extrativa, Transformação E De Serviços De Utilidade Pública",3728.8500061035156,0,2,2
2,Até 5ª Incompleto,1223,Diretores De Operações De Obras Em Empresa De Construção,2341.6610107421875,-4,3,7
2,Até 5ª Incompleto,1224,Diretores De Operações Em Empresa Do Comércio,1844.5714285714287,-1,3,4
2,Até 5ª Incompleto,1225,"Diretores De Serviços De Turismo, De Alojamento E De Alimentação",1161.216015625,-1,2,3
2,Até 5ª Incompleto,1226,"Diretores De Operações De Serviços Em Empresa De Armazenamento, De Transporte E De Telecomunicação",3992.8384738498266,-3,5,8
2,Até 5ª Incompleto,1227,Diretores De Operações De Serviços Em Instituição De Intermediação Financeira,6060,1,1,0
2,Até 5ª Incompleto,1231,Diretores Administrativos E Financeiros,4700.687972067589,9,118,109
2,Até 5ª Incompleto,1232,Diretores De Recursos Humanos E Relações De Trabalho,6600,1,1,0
2,Até 5ª Incompleto,1233,Diretores De Comercialização E Marketing,1788.1836126189128,-3,158,161
2,Até 5ª Incompleto,1234,Diretores De Suprimentos E Afins,1359.2449951171875,0,2,2
2,Até 5ª Incompleto,1236,Diretores De Tecnologia Da Informação,3000,7,7,0
2,Até 5ª Incompleto,1238,Diretores De Manutenção,39412.74627685547,-4,2,6
2,Até 5ª Incompleto,1311,"Diretores E Gerentes De Operações Em Empresa De Serviços Pessoais, Sociais E Culturais",2349.3387570732484,1,148,147
2,Até 5ª Incompleto,1312,"Gestores E Especialistas De Operações Em Empresas, Secretarias E Unidades De Serviços De Saúde",2860.9630044678624,-1,17,18
2,Até 5ª Incompleto,1313,Diretores E Gerentes De Instituição De Serviços Educacionais,1391.7891705897675,-2,31,33
2,Até 5ª Incompleto,1411,"Gerentes De Produção E Operações Em Empresa Agropecuária, Pesqueira, Aqüícola E Florestal",2593.566906217613,-141,651,792
2,Até 5ª Incompleto,1412,"Gerentes De Produção E Operações Em Empresa Da Indústria Extrativa, De Transformação E De Serviços De Utilidade Pública",2509.283767866748,-127,532,659
2,Até 5ª Incompleto,1413,Gerentes De Obras Em Empresa De Construção,2992.271358548678,-6,160,166
2,Até 5ª Incompleto,1414,Gerentes De Operações Comerciais E De Assistência Técnica,1820.7400221599405,-248,943,1191
2,Até 5ª Incompleto,1415,"Gerentes De Operações De Serviços Em Empresa De Turismo, De Alojamento E Alimentação",1994.4272476901062,-77,197,274
2,Até 5ª Incompleto,1416,"Gerentes De Operações De Serviços Em Empresa De Transporte, De Comunicação E De Logística (Armazenagem E Distribuição)",2874.1124502816733,-57,141,198
2,Até 5ª Incompleto,1417,Gerentes De Operações De Serviços Em Instituição De Intermediação Financeira,3316.087168771792,8,35,27
2,Até 5ª Incompleto,1418,Gerentes Operacionais Da Aviação Civil,1357.142857142857,0,7,7
2,Até 5ª Incompleto,1421,"Gerentes Administrativos, Financeiros, De Riscos E Afins",2995.866317306082,-102,1202,1304
2,Até 5ª Incompleto,1422,Gerentes De Recursos Humanos E De Relações Do Trabalho,2919.8010827927365,-10,36,46
2,Até 5ª Incompleto,1423,"Gerentes De Comercialização, Marketing E Comunicação",2874.259326142681,-61,661,722
2,Até 5ª Incompleto,1424,Gerentes De Suprimentos E Afins,2781.2431124128125,-31,51,82
2,Até 5ª Incompleto,1425,Gerentes De Tecnologia Da Informação,4336.079149020448,-14,15,29
2,Até 5ª Incompleto,1426,Gerentes De Pesquisa E Desenvolvimento E Afins,1906.2889133029514,-1,4,5
2,Até 5ª Incompleto,1427,Gerentes De Manutenção E Afins,3711.482335611979,-14,68,82
2,Até 5ª Incompleto,2012,Profissionais Da Metrologia,1363.719970703125,-2,0,2
2,Até 5ª Incompleto,2021,"Engenheiros De Controle E Automação, Engenheiros Mecatrônicos E Afins",1566.9825134277344,1,2,1
2,Até 5ª Incompleto,2030,Pesquisadores Das Ciências Biológicas,1337.5999755859375,-1,0,1
2,Até 5ª Incompleto,2031,Pesquisadores Das Ciências Naturais E Exatas,19945,-2,0,2
2,Até 5ª Incompleto,2033,Pesquisadores Das Ciências Da Saúde,16219.094970703125,0,1,1
2,Até 5ª Incompleto,2034,Pesquisadores Das Ciências Da Agricultura,1605.6050109863281,0,2,2
2,Até 5ª Incompleto,2035,Pesquisadores Das Ciências Sociais E Humanas,1868.3700358072917,-1,1,2
2,Até 5ª Incompleto,2111,Profissionais Da Matemática,1243.3333333333333,1,2,1
2,Até 5ª Incompleto,2122,Engenheiros Em Computação,11925.420239257812,2,4,2
2,Até 5ª Incompleto,2123,Administradores De Tecnologia Da Informação,6602.489632500543,-3,15,18
2,Até 5ª Incompleto,2124,Analistas De Tecnologia Da Informação,2915.9910894114064,-5,77,82
2,Até 5ª Incompleto,2132,Químicos,1668.2679239908853,-1,3,4
2,Até 5ª Incompleto,2140,Engenheiros Ambientais E Afins,2526.1017333984373,7,8,1
2,Até 5ª Incompleto,2141,Arquitetos E Urbanistas,2039.3168774699602,-5,28,33
2,Até 5ª Incompleto,2142,Engenheiros Civis E Afins,2411.0871977654783,6,67,61
2,Até 5ª Incompleto,2143,"Engenheiros Eletricistas, Eletrônicos E Afins",3481.8387958642206,5,21,16
2,Até 5ª Incompleto,2144,Engenheiros Mecânicos E Afins,4194.821587857334,4,14,10
2,Até 5ª Incompleto,2145,Engenheiros Químicos E Afins,7226.445068359375,-2,0,2
2,Até 5ª Incompleto,2146,"Engenheiros Metalurgistas, De Materiais E Afins",4437.159942626953,0,2,2
2,Até 5ª Incompleto,2147,Engenheiros De Minas E Afins,2759.830078125,-2,0,2
2,Até 5ª Incompleto,2148,Engenheiros Agrimensores E Engenheiros Cartógrafos,3213,2,5,3
2,Até 5ª Incompleto,2149,"Engenheiros De Produção, Qualidade, Segurança E Afins",3449.229205322266,1,17,16
2,Até 5ª Incompleto,2151,Oficiais De Convés E Afins,2135.4357104700853,-4,25,29
2,Até 5ª Incompleto,2152,Oficiais De Máquinas Da Marinha Mercante,1408.47998046875,0,1,1
2,Até 5ª Incompleto,2153,Profissionais Da Pilotagem Aeronáutica,2710.7227783203125,0,6,6
2,Até 5ª Incompleto,2211,Biólogos E Afins,1615.9433186848958,1,2,1
2,Até 5ª Incompleto,2212,Biomédicos,1762.6666666666667,1,2,1
2,Até 5ª Incompleto,2221,Engenheiros Agrossilvipecuários,3135.2104354194976,-1,16,17
2,Até 5ª Incompleto,2232,Cirurgiões-Dentistas,2453.5743827819824,5,9,4
2,Até 5ª Incompleto,2233,Veterinários E Zootecnistas,2777.9932560996403,0,15,15
2,Até 5ª Incompleto,2234,Farmacêuticos,2445.9507278245073,2,66,64
2,Até 5ª Incompleto,2235,Enfermeiros E Afins,3334.0837843803142,-42,78,120
2,Até 5ª Incompleto,2236,Fisioterapeutas,2770.2448397549715,-3,15,18
2,Até 5ª Incompleto,2237,Nutricionistas,1678.8695888812724,-3,38,41
2,Até 5ª Incompleto,2238,Fonoaudiólogos,2363.8569946289063,-2,4,6
2,Até 5ª Incompleto,2239,"Terapeutas Ocupacionais, Ortoptistas E Psicomotricistas",1796.3507737379807,-7,3,10
2,Até 5ª Incompleto,2241,Profissionais Da Educação Física,4568.2610047839935,-1,42,43
2,Até 5ª Incompleto,2251,Médicos Clínicos,11154.065184626092,18,51,33
2,Até 5ª Incompleto,2252,Médicos Em Especialidades Cirúrgicas,3790.23574296255,1,10,9
2,Até 5ª Incompleto,2253,Médicos Em Medicina Diagnóstica E Terapêutica,3409.5850830078125,-2,0,2
2,Até 5ª Incompleto,2311,Professores De Nível Superior Na Educação Infantil,1680.4189875732786,-2,69,71
2,Até 5ª Incompleto,2312,Professores De Nível Superior Do Ensino Fundamental (Primeira A Quarta Séries),9222.224278041294,45,98,53
2,Até 5ª Incompleto,2313,Professores De Nível Superior No Ensino Fundamental De Quinta A Oitava Série,1464.6035402767243,-6,15,21
2,Até 5ª Incompleto,2321,Professores Do Ensino Médio,1973.167933877581,-6,18,24
2,Até 5ª Incompleto,2331,Professores Do Ensino Profissional,2316.789998372396,-4,0,4
2,Até 5ª Incompleto,2332,Instrutores De Ensino Profissional,1863.092335094105,-19,20,39
2,Até 5ª Incompleto,2343,"Professores De Arquitetura E Urbanismo, Engenharia, Geofísica E Geologia Do Ensino Superior",3200,1,2,1
2,Até 5ª Incompleto,2344,Professores De Ciências Biológicas E Da Saúde Do Ensino Superior,1091.4466552734375,-2,4,6
2,Até 5ª Incompleto,2345,Professores Na Área De Formação Pedagógica Do Ensino Superior,4398.111107325313,-22,7,29
2,Até 5ª Incompleto,2346,Professores Nas Áreas De Língua E Literatura Do Ensino Superior,7315.786196899414,-6,4,10
2,Até 5ª Incompleto,2347,Professores De Ciências Humanas Do Ensino Superior,403.3999938964844,-1,0,1
2,Até 5ª Incompleto,2348,"Professores De Ciências Econômicas, Administrativas E Contábeis Do Ensino Superior",1395.8600463867188,0,1,1
2,Até 5ª Incompleto,2349,Professores De Artes Do Ensino Superior,19.7450008392334,0,1,1
2,Até 5ª Incompleto,2392,Professores De Educação Especial,2505.470011393229,-3,2,5
2,Até 5ª Incompleto,2394,"Programadores, Avaliadores E Orientadores De Ensino",5908.035502686833,-29,49,78
2,Até 5ª Incompleto,2410,Advogados,5825.2895558965765,-1,23,24
2,Até 5ª Incompleto,2413,Tabeliães E Registradores,1465.2436150444876,-9,4,13
2,Até 5ª Incompleto,2511,Profissionais Em Pesquisa E Análise Antropológica Sociológica,1238.1099853515625,0,1,1
2,Até 5ª Incompleto,2512,Economistas,2173.5005401842523,-2,11,13
2,Até 5ª Incompleto,2515,Psicólogos E Psicanalistas,2501.753913031684,6,16,10
2,Até 5ª Incompleto,2516,Assistentes Sociais E Economistas Domésticos,1933.4131982421875,-6,10,16
2,Até 5ª Incompleto,2521,Administradores,2663.7788899304396,-24,457,481
2,Até 5ª Incompleto,2522,Contadores E Afins,3338.990403238271,-8,95,103
2,Até 5ª Incompleto,2523,Secretárias(Os) Executivas(Os) E Afins,9138.7687989795,-30,261,291
2,Até 5ª Incompleto,2524,Profissionais De Recursos Humanos,2723.534730699327,2,37,35
2,Até 5ª Incompleto,2525,Profissionais De Administração Ecônomico-Financeira,1671.7320272070729,4,32,28
2,Até 5ª Incompleto,2526,Profissionais Da Administração Dos Serviços De Segurança,1815.760009765625,1,3,2
2,Até 5ª Incompleto,2527,"Profissionais De Planejamento, Programação E Controles Logisticos",2851.9032451612425,-1,18,19
2,Até 5ª Incompleto,2531,Profissionais De Publicidade,2086.8028821804824,8,30,22
2,Até 5ª Incompleto,2532,Profissionais De Comercializacão E Consultoria De Serviços Bancários,2678.2722414502914,-20,28,48
2,Até 5ª Incompleto,2533,"Corretores De Valores, Ativos Financeiros, Mercadorias E Derivativos",1733.7952952665441,1,9,8
2,Até 5ª Incompleto,2534,Profissionais De Mídias Digitais E Afins,2460,4,5,1
2,Até 5ª Incompleto,2543,Auditores Fiscais Do Trabalho,2606.0896236491653,41,339,298
2,Até 5ª Incompleto,2544,Fiscais De Tributos Estaduais E Municipais,3341.125,1,2,1
2,Até 5ª Incompleto,2545,Profissionais Da Fiscalização De Atividades Urbanas,1532.1111497145432,8,30,22
2,Até 5ª Incompleto,2611,Profissionais Do Jornalismo,4820.466803922632,-13,18,31
2,Até 5ª Incompleto,2612,Profissionais Da Informação,4607.881663004558,-3,5,8
2,Até 5ª Incompleto,2613,Arquivistas E Museólogos,1682.7971992492676,-8,5,13
2,Até 5ª Incompleto,2614,"Filólogos,Tradutores ,Intérpretes E Afins",1896.9968897501626,2,8,6
2,Até 5ª Incompleto,2615,Profissionais Da Escrita,5294.3798828125,1,1,0
2,Até 5ª Incompleto,2616,Editores,1450,0,1,1
2,Até 5ª Incompleto,2617,"Locutores, Comentaristas E Repórteres De Mídias Audiovisuais",1886.8026387500204,-2,44,46
2,Até 5ª Incompleto,2618,Fotógrafos Profissionais,1306.4114990234375,-3,4,7
2,Até 5ª Incompleto,2621,Produtores Artísticos E Culturais,2972.5239537556968,-4,7,11
2,Até 5ª Incompleto,2622,Diretores De Espetáculos E Afins,8517.3294921875,-3,3,6
2,Até 5ª Incompleto,2623,Cenógrafos,2776.267642066592,0,5,5
2,Até 5ª Incompleto,2624,"Artistas Visuais,Desenhistas Industriais E Conservadores-Restauradores De Bens Culturais",3056.3587551027367,10,74,64
2,Até 5ª Incompleto,2625,Atores,2302.805001395089,-12,1,13
2,Até 5ª Incompleto,2626,"Músicos Compositores, Arranjadores, Regentes E Musicólogos",1171.3209344773065,-1,4,5
2,Até 5ª Incompleto,2627,Músicos Intérpretes,1978.3146779378253,-2,8,10
2,Até 5ª Incompleto,2628,Artistas Da Dança (Exceto Dança Tradicional E Popular),1303.625333658854,-4,3,7
2,Até 5ª Incompleto,2631,"Ministros De Culto, Missionários, Teólogos E Profissionais Assemelhados",5014.311248779297,1,5,4
2,Até 5ª Incompleto,2711,Chefes De Cozinha E Afins,1749.9751691252127,-128,231,359
2,Até 5ª Incompleto,3001,Técnicos Em Mecatrônica,2107.536675347222,-1,4,5
2,Até 5ª Incompleto,3003,Técnicos Em Eletromecânica,2115.2270360323464,7,54,47
2,Até 5ª Incompleto,3011,Técnicos De Laboratório Industrial,1776.2284873836936,-49,384,433
2,Até 5ª Incompleto,3111,Técnicos Químicos,3492.3520380655923,-5,24,29
2,Até 5ª Incompleto,3112,"Técnicos De Produção De Indústrias Químicas, Petroquímicas, Refino De Petróleo, Gás E Afins",1320,1,1,0
2,Até 5ª Incompleto,3113,"Técnicos Em Materiais, Produtos Cerâmicos E Vidros",1758.9085780552455,-6,4,10
2,Até 5ª Incompleto,3114,Técnicos Em Fabricação De Produtos Plásticos E De Borracha,1732.1958794976892,-11,93,104
2,Até 5ª Incompleto,3115,"Técnicos Em Controle Ambiental, Utilidades E Tratamento De Efluentes",1956.755485331055,4,85,81
2,Até 5ª Incompleto,3116,Técnicos Têxteis,2597.3550140380858,-5,3,8
2,Até 5ª Incompleto,3117,Coloristas,10515.880527084435,-194,708,902
2,Até 5ª Incompleto,3121,Técnicos Em Construção Civil (Edificações),2320.2251424638052,38,271,233
2,Até 5ª Incompleto,3122,Técnicos Em Construção Civil (Obras De Infraestrutura),2057.13091255188,32,181,149
2,Até 5ª Incompleto,3123,Técnicos Em Geomática,7026.637707288071,-110,1074,1184
2,Até 5ª Incompleto,3131,Técnicos Em Eletricidade E Eletrotécnica,3077.4514304467352,-81,820,901
2,Até 5ª Incompleto,3132,Técnicos Em Eletrônica,1717.9886092441461,-36,294,330
2,Até 5ª Incompleto,3133,Técnicos Em Telecomunicações,1628.9463902939292,16,228,212
2,Até 5ª Incompleto,3134,Técnicos Em Calibração E Instrumentação,2205.527997778114,-24,158,182
2,Até 5ª Incompleto,3135,Técnicos Em Fotônica,1696.3251607259115,10,35,25
2,Até 5ª Incompleto,3141,"Técnicos Mecânicos Na Fabricação E Montagem De Máquinas, Sistemas E Instrumentos",2109.082038205694,-59,366,425
2,Até 5ª Incompleto,3142,Técnicos Mecânicos (Ferramentas),2229.696903076172,-18,19,37
2,Até 5ª Incompleto,3143,Técnicos Em Mecânica Veicular,1894.0090881373842,-2,26,28
2,Até 5ª Incompleto,3144,"Técnicos Mecânicos Na Manutenção De Máquinas, Sistemas E Instrumentos",7903.457606984149,-26,109,135
2,Até 5ª Incompleto,3146,Técnicos Em Metalurgia (Estruturas Metálicas),2520.040253493624,-10,39,49
2,Até 5ª Incompleto,3147,Técnicos Em Siderurgia,2334.202566092355,-11,8,19
2,Até 5ª Incompleto,3148,Especialistas Em Inspeções Industriais,2581.6175048828127,2,5,3
2,Até 5ª Incompleto,3161,Técnicos Em Geologia,1802.8185065774355,-1,10,11
2,Até 5ª Incompleto,3163,Técnicos Em Mineração,2121.795705820059,1,12,11
2,Até 5ª Incompleto,3171,Técnicos De Desenvolvimento De Sistemas E Aplicações,2596.466483302848,-5,36,41
2,Até 5ª Incompleto,3172,Técnicos De Suporte E Monitoração Ao Usuário De Tecnologia Da Informação.,1712.8780909297386,-5,91,96
2,Até 5ª Incompleto,3180,"Desenhistas Técnicos, Em Geral",2672.8017768012155,-3,5,8
2,Até 5ª Incompleto,3181,Desenhistas Técnicos Da Construção Civil E Arquitetura,2667.0026557074657,-3,12,15
2,Até 5ª Incompleto,3182,Desenhistas Técnicos Da Mecânica,1176.9809126420455,2,12,10
2,Até 5ª Incompleto,3183,"Desenhistas Técnicos Em Eletricidade, Eletrônica, Eletromecânica, Calefação, Ventilação E Refrigeração",1827.6349853515626,-2,2,4
2,Até 5ª Incompleto,3184,Desenhistas Técnicos De Produtos E Serviços Diversos,1653.3353172665552,-8,14,22
2,Até 5ª Incompleto,3185,Desenhistas Projetistas De Construção Civil E Arquitetura,2076.8554341634117,-1,18,19
2,Até 5ª Incompleto,3186,Desenhistas Projetistas Da Mecânica,3869.4016842312285,-7,3,10
2,Até 5ª Incompleto,3187,Desenhistas Projetistas Da Eletrônica,2121.1033528645835,1,2,1
2,Até 5ª Incompleto,3188,Desenhistas Projetistas E Modelistas De Produtos E Serviços Diversos,2169.7844677210282,-27,21,48
2,Até 5ª Incompleto,3191,Técnicos Do Vestuário,2718.0314758300783,-10,1,11
2,Até 5ª Incompleto,3192,Técnicos Do Mobiliário E Afins,3203.6400390625,1,3,2
2,Até 5ª Incompleto,3201,Técnicos Em Biologia,1798.6627906976744,-1,21,22
2,Até 5ª Incompleto,3211,Técnicos Agrícolas,3447.404791232663,-92,145,237
2,Até 5ª Incompleto,3212,Técnicos Florestais,1481.3273070875289,-25,286,311
2,Até 5ª Incompleto,3213,Técnicos Em Aqüicultura,1314.523103964449,-9,10,19
2,Até 5ª Incompleto,3221,Tecnólogos E Técnicos Em Terapias Complementares E Estéticas,1685.0654972330728,-9,37,46
2,Até 5ª Incompleto,3222,Técnicos E Auxiliares De Enfermagem,2000.5632659573491,-627,655,1282
2,Até 5ª Incompleto,3223,Técnicos Em Óptica E Optometria,2763.1500133167615,-5,3,8
2,Até 5ª Incompleto,3224,Técnicos De Odontologia,2409.9586321165957,-24,79,103
2,Até 5ª Incompleto,3225,Técnicos Em Próteses Ortopédicas,2200,0,1,1
2,Até 5ª Incompleto,3226,Técnicos De Imobilizações Ortopédicas,1326.83251953125,-2,1,3
2,Até 5ª Incompleto,3231,Técnicos Em Pecuária,1551.0408219962285,16,37,21
2,Até 5ª Incompleto,3241,Tecnólogos E Técnicos Em Métodos De Diagnósticos E Terapêutica,2170.808941650391,-4,20,24
2,Até 5ª Incompleto,3242,Técnicos De Laboratórios De Saúde E Bancos De Sangue,1734.3719856955788,-22,23,45
2,Até 5ª Incompleto,3250,"Enólogos, Perfumistas E Aromistas",1328.9472767223012,1,6,5
2,Até 5ª Incompleto,3251,Técnico Em Farmácia E Em Manipulação Farmacêutica,1578.5135376787414,4,23,19
2,Até 5ª Incompleto,3252,"Técnicos Em Produção, Conservação  E De Qualidade De Alimentos",1695.2830147710158,2,111,109
2,Até 5ª Incompleto,3253,Técnicos De Apoio À Biotecnologia,1522.2320068359375,1,3,2
2,Até 5ª Incompleto,3281,Técnicos Em Necrópsia E Taxidermistas,1086,-1,0,1
2,Até 5ª Incompleto,3311,Professores De Nível Médio Na Educação Infantil,1805.2017726641106,-49,195,244
2,Até 5ª Incompleto,3312,Professores De Nível Médio No Ensino Fundamental,2262.2123757164077,-6,51,57
2,Até 5ª Incompleto,3313,Professores De Nível Médio No Ensino Profissionalizante,1443.8049987157185,2,4,2
2,Até 5ª Incompleto,3321,Professores Leigos No Ensino Fundamental,436.7299973060345,7,18,11
2,Até 5ª Incompleto,3322,Professores Práticos No Ensino Profissionalizante,5210.669921875,-1,0,1
2,Até 5ª Incompleto,3331,Instrutores E Professores De Cursos Livres,1615.0814950965948,-16,115,131
2,Até 5ª Incompleto,3341,Inspetores De Alunos E Afins,1544.514883336841,-339,1009,1348
2,Até 5ª Incompleto,3411,"Pilotos De Aviação Comercial, Mecânicos De Vôo E Afins",2806.9979980468747,0,8,8
2,Até 5ª Incompleto,3412,"Técnicos Marítimos, Fluviários E Pescadores De Convés",2027.3003483562045,-14,475,489
2,Até 5ª Incompleto,3413,Técnicos Marítimos E Fluviários De Máquinas,1653.3754468421228,-24,258,282
2,Até 5ª Incompleto,3421,Especialistas Em Logística De Transportes,1863.3940373960322,-101,259,360
2,Até 5ª Incompleto,3422,Despachantes Aduaneiros,1239.4778257040452,-27,83,110
2,Até 5ª Incompleto,3423,Técnicos Em Transportes Rodoviários,3348.6529534859296,-168,315,483
2,Até 5ª Incompleto,3424,Técnicos Em Transportes Metroferroviários,2002.643712419849,-51,26,77
2,Até 5ª Incompleto,3425,Técnicos Em Transportes Aéreos,2459.805728149414,-9,8,17
2,Até 5ª Incompleto,3426,Técnicos Em Transportes Por Vias Navegáveis E Operações Portuárias,1665.3230523003472,-10,5,15
2,Até 5ª Incompleto,3511,Técnicos Em Contabilidade,1539.0915067436442,4,23,19
2,Até 5ª Incompleto,3513,Técnicos Em Administração,2053.263587623585,-28,100,128
2,Até 5ª Incompleto,3514,Serventuários Da Justiça E Afins,3346.9152336505927,-3,40,43
2,Até 5ª Incompleto,3515,"Técnicos Em Secretariado, Taquígrafos E Estenotipistas",1345.3692896095952,-22,71,93
2,Até 5ª Incompleto,3516,Técnicos Em Segurança Do Trabalho,5816.560997656897,0,282,282
2,Até 5ª Incompleto,3517,Técnicos De Seguros E Afins,2889.121449897403,7,57,50
2,Até 5ª Incompleto,3522,Agentes Da Saúde E Do Meio Ambiente,1622.9517454226188,-16,213,229
2,Até 5ª Incompleto,3523,Agentes  Fiscais Metrológicos E De Qualidade,1909.0473885747601,-23,50,73
2,Até 5ª Incompleto,3524,Profissionais De Direitos Autorais E De Avaliacão De Produtos Dos Meios De Comunicação,1227.7799886067708,-1,1,2
2,Até 5ª Incompleto,3532,Técnicos Em Operações E Serviços Bancários,2571.4692001342773,-9,2,11
2,Até 5ª Incompleto,3541,Especialistas Em Promoção De Produtos E Vendas,2426.606813231961,-76,901,977
2,Até 5ª Incompleto,3542,Compradores,3481.63027211081,-6,102,108
2,Até 5ª Incompleto,3543,Analistas De Comércio Exterior,2237.9172585227275,-1,5,6
2,Até 5ª Incompleto,3544,Leiloeiros E Avaliadores,1229.5158284505208,0,6,6
2,Até 5ª Incompleto,3545,Corretores De Seguros,1370.5333251953125,0,3,3
2,Até 5ª Incompleto,3546,Corretores De Imóveis E De Grãos,1370.129409790039,1,9,8
2,Até 5ª Incompleto,3547,Representantes Comerciais Autônomos,1733.750009390024,-2,12,14
2,Até 5ª Incompleto,3548,Técnicos Em Serviços De Turismo E Organização De Eventos,1793.0280547338762,14,67,53
2,Até 5ª Incompleto,3711,Técnicos Em Biblioteconomia,1265.284672178071,-5,13,18
2,Até 5ª Incompleto,3713,Técnicos Em Artes Gráficas,1774.2887573242188,-1,2,3
2,Até 5ª Incompleto,3714,Recreadores,1493.6039107781244,20,239,219
2,Até 5ª Incompleto,3721,Captadores De Imagens Em Movimento,1768.6924959070543,-1,10,11
2,Até 5ª Incompleto,3722,Operadores De Rede De Teleprocessamento E Afins,1288.0982439377728,-5,6,11
2,Até 5ª Incompleto,3731,Técnicos De Operação De Registros Sonoro/Audiovisuais,1907.3193325050295,-14,31,45
2,Até 5ª Incompleto,3732,Supervisores Operacionais E Técnicos Em Mídias Audiovisuais,4557.494339231461,-11,2,13
2,Até 5ª Incompleto,3741,Técnicos Em Áudio,1957.8727445955278,-15,134,149
2,Até 5ª Incompleto,3742,Técnicos Em Cenografia,2288.1363644035846,-10,27,37
2,Até 5ª Incompleto,3743,Técnicos Em Operação De Aparelhos De Projeção,1827.5320790608725,-4,5,9
2,Até 5ª Incompleto,3744,"Técnicos Em Montagem, Edição E Finalização De Mídia Audiovisual",1654.2025419837014,-54,166,220
2,Até 5ª Incompleto,3751,"Designers De Interiores, De Vitrines E Visual Merchandiser E Afins (Nível Médio)",1455.0894978522258,5,28,23
2,Até 5ª Incompleto,3761,Dançarinos Tradicionais E Populares,1810.6599731445313,-2,0,2
2,Até 5ª Incompleto,3762,Artistas De Circo (Circenses),1534.6392067357115,-12,7,19
2,Até 5ª Incompleto,3763,"Apresentadores De Eventos, Programas E Espetáculos",1467.876201811291,-3,6,9
2,Até 5ª Incompleto,3771,Atletas Profissionais,3382.440016740523,33,223,190
2,Até 5ª Incompleto,3772,Árbitros Desportivos,3360.0350341796875,0,1,1
2,Até 5ª Incompleto,3911,"Planejadores, Programadores E Controladores De Produção E Manutenção",16274.126779454573,-247,865,1112
2,Até 5ª Incompleto,3912,Técnicos De Controle Da Produção,2040.4547348357094,-185,733,918
2,Até 5ª Incompleto,3951,Técnicos De Apoio Em Pesquisa E Desenvolvimento,2108.3266932183924,-21,73,94
2,Até 5ª Incompleto,4101,Supervisores Administrativos,2468.791911088534,-719,1152,1871
2,Até 5ª Incompleto,4102,"Supervisores De Serviços Financeiros, De Câmbio E De Controle",2015.6368029798407,-89,185,274
2,Até 5ª Incompleto,4110,"Agentes, Assistentes E Auxiliares Administrativos",1527.5218327704042,-1668,10401,12069
2,Até 5ª Incompleto,4121,Operadores De Equipamentos De Entrada E Transmissão De Dados,1592.1248507181801,0,59,59
2,Até 5ª Incompleto,4122,Contínuos,1352.6545336078207,-603,3121,3724
2,Até 5ª Incompleto,4131,Auxiliares De Contabilidade,1842.972328098517,-40,277,317
2,Até 5ª Incompleto,4132,Escriturários De Serviços Bancários,1738.5504520558657,-87,114,201
2,Até 5ª Incompleto,4141,Almoxarifes E Armazenistas,1724.4667603696544,-84,17831,17915
2,Até 5ª Incompleto,4142,Apontadores E Conferentes,2183.1173887539226,-810,3572,4382
2,Até 5ª Incompleto,4151,"Auxiliares De Serviços De Documentação, Informação E Pesquisa",3169.864252829756,-31,38,69
2,Até 5ª Incompleto,4152,"Trabalhadores Nos Serviços De Classificação E Entregas De Correspondências, Encomendas E Publicações",1406.2846484031513,-22,188,210
2,Até 5ª Incompleto,4201,Supervisores De Atendimento Ao Público E De Pesquisa,2190.238740961435,-42,57,99
2,Até 5ª Incompleto,4211,Caixas E Bilheteiros (Exceto Caixa De Banco),1403.871801340572,-405,2932,3337
2,Até 5ª Incompleto,4212,Coletadores De Apostas E De Jogos,1301.4697287230365,1,57,56
2,Até 5ª Incompleto,4213,Cobradores E Afins,1413.9577704612905,-123,217,340
2,Até 5ª Incompleto,4221,Recepcionistas,1474.1975948979798,-115,2021,2136
2,Até 5ª Incompleto,4222,Operadores De Telefonia,1514.9298880430556,-21,76,97
2,Até 5ª Incompleto,4223,Operadores De Telemarketing E Afins,1421.6621880306113,-174,224,398
2,Até 5ª Incompleto,4231,Despachantes Documentalistas E Afins,1655.148114915566,5,107,102
2,Até 5ª Incompleto,4241,Entrevistadores E Recenseadores,2889.79135172526,-14,20,34
2,Até 5ª Incompleto,4242,Aplicadores De Provas E Afins,1945.1199951171875,0,1,1
2,Até 5ª Incompleto,5101,"Supervisores Dos Serviços De Transporte, Turismo, Hotelaria E Administração De Edifícios",2058.951593518376,-146,163,309
2,Até 5ª Incompleto,5102,Supervisores De Lavanderia,1639.9219416865596,-32,38,70
2,Até 5ª Incompleto,5103,"Supervisores Dos Serviços De Proteção, Segurança E Outros",2180.9471883493006,-59,43,102
2,Até 5ª Incompleto,5111,Trabalhadores De Segurança E Atendimento Aos Usuários Nos Transportes,1670.6705443367125,0,17,17
2,Até 5ª Incompleto,5112,Fiscais E Cobradores Dos Transportes Coletivos,2303.863096046094,-971,620,1591
2,Até 5ª Incompleto,5114,Guias De Turismo,1664.5911738408076,-1,38,39
2,Até 5ª Incompleto,5115,Condutores De Turismo,1520.1492832728795,2,7,5
2,Até 5ª Incompleto,5121,Trabalhadores Dos Serviços Domésticos Em Geral,2002.2924427497019,291,1725,1434
2,Até 5ª Incompleto,5131,Mordomos E Governantas,1393.6899494777838,-11,187,198
2,Até 5ª Incompleto,5132,Cozinheiros,3426.4431671986395,-2459,20118,22577
2,Até 5ª Incompleto,5133,"Camareiros, Roupeiros E Afins",1582.1310763080285,-365,5310,5675
2,Até 5ª Incompleto,5134,"Trabalhadores No Atendimento Em Estabelecimentos De Serviços De Alimentação, Bebidas E Hotelaria",1544.2535674190049,-1894,12080,13974
2,Até 5ª Incompleto,5135,Trabalhadores Auxiliares Nos Serviços De Alimentação,1523.8894905089544,534,19578,19044
2,Até 5ª Incompleto,5136,"Churrasqueiros, Pizzaiolos E Sushimen",1626.2034620006932,-47,1279,1326
2,Até 5ª Incompleto,5141,Trabalhadores Nos Serviços De Administração De Edifícios,1760.6168630883715,-1400,12546,13946
2,Até 5ª Incompleto,5142,"Trabalhadores Nos Serviços De Coleta De Resíduos, De Limpeza E Conservação De Áreas Públicas",1579.8850512785398,-2872,35622,38494
2,Até 5ª Incompleto,5143,Trabalhadores Nos  Serviços De Manutenção De Edificações,1526.6077230539304,1364,152954,151590
2,Até 5ª Incompleto,5151,Trabalhadores Em Serviços De Promoção E Apoio À Saúde,1468.6581373789809,9,534,525
2,Até 5ª Incompleto,5152,Auxiliares De Laboratório Da Saúde,2001.378535180435,-49,228,277
2,Até 5ª Incompleto,5153,"Trabalhadores De Atenção, Defesa E Proteção A Pessoas Em Situação De Risco E Adolescentes Em Conflito Com A Lei",1368.5123094408955,5,262,257
2,Até 5ª Incompleto,5161,Trabalhadores Nos Serviços De Embelezamento E Higiene,1590.8663288367422,-96,114,210
2,Até 5ª Incompleto,5162,"Cuidadores De Crianças, Jovens, Adultos E Idosos",1777.2262450028147,-35,1018,1053
2,Até 5ª Incompleto,5163,"Tintureiros, Lavadeiros E Afins, A Máquina",1533.616609110738,-376,3158,3534
2,Até 5ª Incompleto,5164,"Lavadores E Passadores De Roupa, A Mão",1389.4722944481991,-67,258,325
2,Até 5ª Incompleto,5165,Trabalhadores Dos Serviços Funerários,1502.472332175008,10,202,192
2,Até 5ª Incompleto,5166,Trabalhadores Auxiliares Dos Serviços Funerários,2185.352902672337,67,421,354
2,Até 5ª Incompleto,5171,"Bombeiros, Salva-Vidas E Afins",2062.537259347722,-71,234,305
2,Até 5ª Incompleto,5172,"Policiais, Guardas-Civis Municipais E Agentes De Trânsito",1435.576086463574,-25,67,92
2,Até 5ª Incompleto,5173,Vigilantes E Guardas De Segurança,1877.060411194052,-1170,3868,5038
2,Até 5ª Incompleto,5174,"Porteiros, Vigias E Afins",2838.012933911738,-5429,20850,26279
2,Até 5ª Incompleto,5191,Motociclistas E Ciclistas De Entregas Rápidas,1399.0463707153122,117,1653,1536
2,Até 5ª Incompleto,5192,Trabalhadores Da Coleta E Seleção De Material Reciclável,1553.0517799253241,47,1758,1711
2,Até 5ª Incompleto,5193,"Trabalhadores De Serviços Veterinários, De Higiene E Estética De Animais Domésticos",2278.228078460802,-5,216,221
2,Até 5ª Incompleto,5199,Outros Trabalhadores Dos Serviços,2179.239983115919,-308,4470,4778
2,Até 5ª Incompleto,5201,Supervisores De Vendas E De Prestação De Serviços,2261.8250280980974,-82,165,247
2,Até 5ª Incompleto,5211,Operadores Do Comércio Em Lojas E Mercados,1536.6509171204661,-3041,28362,31403
2,Até 5ª Incompleto,5231,Instaladores De Produtos E Acessórios,1578.2119336268624,-18,217,235
2,Até 5ª Incompleto,5241,Vendedores Em Domicílio,1265.4541892553036,-33,363,396
2,Até 5ª Incompleto,5242,"Vendedores Em Bancas, Quiosques E Barracas",1272.8795932166104,-28,60,88
2,Até 5ª Incompleto,5243,Vendedores Ambulantes,1413.5830690210514,-10,62,72
2,Até 5ª Incompleto,6110,Produtores Agropecuários Em Geral,1323.2386834834733,-60,384,444
2,Até 5ª Incompleto,6120,Produtores Agrícolas Polivalentes,1443.8579739373827,-35,455,490
2,Até 5ª Incompleto,6121,Produtores Agrícolas Na Cultura De Gramíneas,1469.7250600509724,2,67,65
2,Até 5ª Incompleto,6123,Produtores Agrícolas Na Olericultura,1389.8900999688385,-7,47,54
2,Até 5ª Incompleto,6124,Produtores Agrícolas No Cultivo De Flores E Plantas Ornamentais,1368.8980215567128,-2,14,16
2,Até 5ª Incompleto,6125,Produtores Agrícolas Na Fruticultura,1221.2442605931903,22,312,290
2,Até 5ª Incompleto,6126,Produtores Agrícolas Na Cultura De Plantas Estimulantes,1141.2319946289063,-1,3,4
2,Até 5ª Incompleto,6127,Produtores Agrícolas Na Cultura De Plantas Oleaginosas,1495,2,4,2
2,Até 5ª Incompleto,6128,Produtores De Especiarias E De Plantas Aromáticas E Medicinais,2000,1,1,0
2,Até 5ª Incompleto,6130,Produtores Em Pecuária Polivalente,1359.1939194419167,-7,46,53
2,Até 5ª Incompleto,6131,Produtores Em Pecuária De Animais De Grande Porte,1473.7769915765316,-19,196,215
2,Até 5ª Incompleto,6132,Produtores Em Pecuária De Animais De Médio Porte,1494.0285737299357,-12,50,62
2,Até 5ª Incompleto,6133,Produtores Da Avicultura E Cunicultura,1540.149575921424,7,339,332
2,Até 5ª Incompleto,6134,Produtores De Animais E Insetos Úteis,1414.7598451556582,2,8,6
2,Até 5ª Incompleto,6201,Supervisores Na Exploração Agropecuária,2592.0463777175883,-787,4180,4967
2,Até 5ª Incompleto,6210,Trabalhadores Agropecuários Em Geral,1722.0655740002446,-5626,90511,96137
2,Até 5ª Incompleto,6220,Trabalhadores De Apoio À Agricultura,1981.0662318453737,-313,87541,87854
2,Até 5ª Incompleto,6221,Trabalhadores Agrícolas Na Cultura De Gramíneas,1498.4983113789458,2585,215500,212915
2,Até 5ª Incompleto,6222,Trabalhadores Agrícolas Na Cultura De Plantas Fibrosas,3252.857079822082,26,284,258
2,Até 5ª Incompleto,6223,Trabalhadores Agrícolas Na Olericultura,1283.163146162974,-151,3321,3472
2,Até 5ª Incompleto,6224,Trabalhadores Agrícolas No Cultivo De Flores E Plantas Ornamentais,1359.1606907327662,-109,1554,1663
2,Até 5ª Incompleto,6225,Trabalhadores Agrícolas Na Fruticultura,2065.791615790809,-3226,89615,92841
2,Até 5ª Incompleto,6226,Trabalhadores Agrícolas Nas Culturas De Plantas Estimulantes,1238.6163497435282,96,22772,22676
2,Até 5ª Incompleto,6227,Trabalhadores Agrícolas Na Cultura De Plantas Oleaginosas,1365.1671573143112,334,4692,4358
2,Até 5ª Incompleto,6228,Trabalhadores Agrícolas Da Cultura De Especiarias E De Plantas Aromáticas E Medicinais,1200.9383306112754,-2,157,159
2,Até 5ª Incompleto,6230,Tratadores Polivalentes De Animais,2026.8331071737098,-175,7958,8133
2,Até 5ª Incompleto,6231,Trabalhadores Na Pecuária De Animais De Grande Porte,1859.39172239873,-1770,27850,29620
2,Até 5ª Incompleto,6232,Trabalhadores Na Pecuária De Animais De Médio Porte,1393.2014589427752,-101,2499,2600
2,Até 5ª Incompleto,6233,Trabalhadores Na Avicultura E Cunicultura,1416.1444219836076,-627,7664,8291
2,Até 5ª Incompleto,6234,Trabalhadores Na Criação De Insetos E Animais Úteis,1365.8588027324633,-13,69,82
2,Até 5ª Incompleto,6301,Supervisores Na Área Florestal E Aqüicultura,2100.057275717463,-55,188,243
2,Até 5ª Incompleto,6310,Pescadores Polivalentes,1443.0556577121952,7,97,90
2,Até 5ª Incompleto,6311,Pescadores Profissionais Artesanais De Água Doce,733.6562184629037,-11,219,230
2,Até 5ª Incompleto,6312,Pescadores De Água Costeira E Alto Mar,4478.862425773313,-150,2950,3100
2,Até 5ª Incompleto,6313,Criadores De Animais Aquáticos,1380.922810938918,63,629,566
2,Até 5ª Incompleto,6314,Trabalhadores De Apoio À Pesca,1504.086306198246,9,138,129
2,Até 5ª Incompleto,6320,Trabalhadores Florestais Polivalentes,1803.695680202345,38,385,347
2,Até 5ª Incompleto,6321,Extrativistas E Reflorestadores De Espécies Produtoras De Madeira,1463.5147301695106,-591,21249,21840
2,Até 5ª Incompleto,6322,Extrativistas Florestais De Espécies Produtoras De Gomas E Resinas,1115.674339888605,-146,1343,1489
2,Até 5ª Incompleto,6323,"Extrativistas Florestais De Espécies Produtoras De Fibras, Ceras E Óleos",1690.651325238953,-44,913,957
2,Até 5ª Incompleto,6324,Extrativistas Florestais De Espécies Produtoras De Alimentos Silvestres,1576.7878831321786,-18,274,292
2,Até 5ª Incompleto,6325,"Extrativistas Florestais De Espécies Produtoras De Substâncias Aromáticas, Medicinais E Tóxicas",1312.8370072859948,-94,116,210
2,Até 5ª Incompleto,6326,Carvoejadores,1455.3251519126045,122,3900,3778
2,Até 5ª Incompleto,6410,Trabalhadores Da Mecanização Agrícola,5328.400010337463,-364,38019,38383
2,Até 5ª Incompleto,6420,Trabalhadores Da Mecanização Florestal,1873.8006968831967,-145,2202,2347
2,Até 5ª Incompleto,6430,Trabalhadores Da Irrigação E Drenagem,1709.9179246878994,-92,1235,1327
2,Até 5ª Incompleto,7101,Supervisores Da Extração Mineral,3629.059029287915,-32,102,134
2,Até 5ª Incompleto,7102,Supervisores Da Construção Civil,4017.03523946139,-711,9571,10282
2,Até 5ª Incompleto,7111,Trabalhadores Da Extração De Minerais Sólidos,1921.5335614950461,-164,1433,1597
2,Até 5ª Incompleto,7112,Trabalhadores De Extração De Minerais Sólidos (Operadores De Máquinas),2759.790266093727,-139,4589,4728
2,Até 5ª Incompleto,7113,Trabalhadores Da Extração De Minerais Líquidos E Gasosos,2504.9753883770763,1,639,638
2,Até 5ª Incompleto,7114,Garimpeiros E Operadores De Salinas,1238.673047075368,24,92,68
2,Até 5ª Incompleto,7121,Trabalhadores De Beneficiamento De Minérios,1657.3402775929746,-36,684,720
2,Até 5ª Incompleto,7122,Trabalhadores De Beneficiamento De Pedras Ornamentais,1620.957032778487,-162,1102,1264
2,Até 5ª Incompleto,7151,Trabalhadores Na Operação De Máquinas De Terraplenagem E Fundações,2420.4811818485964,56,22585,22529
2,Até 5ª Incompleto,7152,Trabalhadores De Estruturas De Alvenaria,3358.38043881144,2389,107205,104816
2,Até 5ª Incompleto,7153,Montadores De Estruturas De Concreto Armado,2465.4650164801046,451,23619,23168
2,Até 5ª Incompleto,7154,Trabalhadores Na Operação De Máquinas De Concreto Usinado E Afins,2824.952213389939,-341,2430,2771
2,Até 5ª Incompleto,7155,"Trabalhadores De Montagem De Estruturas De Madeira, Metal E Compósitos Em Obras Civis",2929.46059650331,678,48509,47831
2,Até 5ª Incompleto,7156,Trabalhadores De Instalações Elétricas,2671.2355449687134,-131,5643,5774
2,Até 5ª Incompleto,7157,Aplicadores De Materiais Isolantes,5693.835694459707,14,1467,1453
2,Até 5ª Incompleto,7161,Revestidores De Concreto,1802.67458159146,-6,254,260
2,Até 5ª Incompleto,7162,Telhadores (Revestimentos Rígidos),1713.3934014004876,-4,56,60
2,Até 5ª Incompleto,7163,Vidraceiros (Revestimentos Rígidos),1651.0266491984764,2,560,558
2,Até 5ª Incompleto,7164,Gesseiros,2290.3612379749593,138,3463,3325
2,Até 5ª Incompleto,7165,"Aplicadores De Revestimentos Cerâmicos, Pastilhas, Pedras E Madeiras",2031.1387881620049,-17,2597,2614
2,Até 5ª Incompleto,7166,Pintores De Obras E Revestidores De Interiores (Revestimentos Flexíveis),2160.1901404631913,-262,10163,10425
2,Até 5ª Incompleto,7170,Ajudantes De Obras Civis,2270.126853639228,17911,213028,195117
2,Até 5ª Incompleto,7201,"Supervisores De Usinagem, Conformação E Tratamento De Metais",4758.619165991194,-83,219,302
2,Até 5ª Incompleto,7202,Supervisores Da Fabricação E Montagem Metalmecânica,3228.294050929155,-31,38,69
2,Até 5ª Incompleto,7211,Ferramenteiros E Afins,5784.098626525648,-25,240,265
2,Até 5ª Incompleto,7212,Preparadores E Operadores De Máquinas-Ferramenta Convencionais,10469.449561986095,-465,1668,2133
2,Até 5ª Incompleto,7213,Afiadores E Polidores De Metais,2123.0046096122,-63,758,821
2,Até 5ª Incompleto,7214,Operadores De Máquinas De Usinagem Cnc,2927.128029810586,-13,234,247
2,Até 5ª Incompleto,7221,Trabalhadores De Forjamento De Metais,2023.3654782109406,-20,880,900
2,Até 5ª Incompleto,7222,Trabalhadores De Fundição De Metais Puros E De Ligas Metálicas,1792.803187346258,-3,1498,1501
2,Até 5ª Incompleto,7223,Trabalhadores De Moldagem De Metais E De Ligas Metálicas,3258.5605496473577,-23,651,674
2,Até 5ª Incompleto,7224,Trabalhadores De Trefilação E Estiramento De Metais Puros E Ligas Metálicas,1729.7051427744857,-27,45,72
2,Até 5ª Incompleto,7231,Trabalhadores De Tratamento Térmico De Metais,3619.4111369284606,-7,72,79
2,Até 5ª Incompleto,7232,Trabalhadores De Tratamento De Superfícies De Metais E De Compósitos (Termoquímicos),1944.9650761725393,-62,354,416
2,Até 5ª Incompleto,7233,"Trabalhadores Da Pintura De Equipamentos, Veículos, Estruturas Metálicas E De Compósitos",2044.7668739488174,-277,2857,3134
2,Até 5ª Incompleto,7241,Encanadores E Instaladores De Tubulações,2402.1917897877356,-425,7861,8286
2,Até 5ª Incompleto,7242,Trabalhadores De Traçagem E Montagem De Estruturas Metálicas E De Compósitos,2239.6611083281073,552,13514,12962
2,Até 5ª Incompleto,7243,Trabalhadores De Soldagem E Corte De Ligas Metálicas,4115.628401718176,-259,8790,9049
2,Até 5ª Incompleto,7244,Trabalhadores De Caldeiraria E Serralheria,6111.845612617127,-76,4664,4740
2,Até 5ª Incompleto,7245,Operadores De Máquinas De Conformação De Metais,2978.9372014644264,-223,731,954
2,Até 5ª Incompleto,7246,Trançadores E Laceiros De Cabos De Aço,2299.4985159414787,-13,16,29
2,Até 5ª Incompleto,7250,Ajustadores Mecânicos Polivalentes E Afins,2381.474879427546,-2,741,743
2,Até 5ª Incompleto,7251,"Montadores De Máquinas, Aparelhos E Acessórios Em Linhas De Montagem",3533.5850168737693,-22,543,565
2,Até 5ª Incompleto,7252,Montadores De Máquinas Industriais,3983.1548074745997,135,2095,1960
2,Até 5ª Incompleto,7253,Montadores De Máquinas Pesadas E Equipamentos Agrícolas,1969.2592509468097,0,166,166
2,Até 5ª Incompleto,7254,Mecânicos Montadores De Motores E Turboalimentadores,2038.7117323083994,-37,78,115
2,Até 5ª Incompleto,7255,Montadores De Veículos Automotores (Linha De Montagem),1733.896806841909,-46,100,146
2,Até 5ª Incompleto,7256,Montadores De Sistemas E Estruturas De Aeronaves,1633.0339965820313,-2,5,7
2,Até 5ª Incompleto,7257,Instaladores De Equipamentos De Refrigeração E Ventilação,1859.3309492985645,10,200,190
2,Até 5ª Incompleto,7301,Supervisores De Montagens E Instalações Eletroeletrônicas,3939.4827056059967,-27,42,69
2,Até 5ª Incompleto,7311,Montadores De Equipamentos Eletroeletrônicos,2989.8546135903794,-209,5739,5948
2,Até 5ª Incompleto,7312,Montadores De Aparelhos De Telecomunicações,1486.7582749586838,-2,25,27
2,Até 5ª Incompleto,7313,Instaladores-Reparadores De  Linhas E Equipamentos De Telecomunicações,1399.3802931080643,-32,247,279
2,Até 5ª Incompleto,7321,"Instaladores E Reparadores De Linhas E Cabos Elétricos, Telefônicos E De Comunicação De Dados",1836.0934551813118,145,3266,3121
2,Até 5ª Incompleto,7401,Supervisores Da Mecânica De Precisão E Instrumentos Musicais,3200.3310302734376,-2,2,4
2,Até 5ª Incompleto,7411,Mecânicos De Instrumentos De Precisão,1758.7975018559107,-12,76,88
2,Até 5ª Incompleto,7421,Confeccionadores De Instrumentos Musicais,2248.4000379774307,-1,4,5
2,Até 5ª Incompleto,7501,Supervisores De Joalheria E Afins,1777.800048828125,1,1,0
2,Até 5ª Incompleto,7502,"Supervisores De Vidraria, Cerâmica E Afins",3305.2030029296875,-2,4,6
2,Até 5ª Incompleto,7510,Joalheiros E Lapidadores De Gemas,1580.9546978152982,-10,35,45
2,Até 5ª Incompleto,7511,Artesãos De Metais Preciosos E Semi-Preciosos,2126.35048223306,-11,64,75
2,Até 5ª Incompleto,7521,"Sopradores, Moldadores E Modeladores De Vidros E Afins",2201.0600428263347,-3,18,21
2,Até 5ª Incompleto,7522,Trabalhadores Da Transformação De Vidros Planos,1712.9770706001573,-14,132,146
2,Até 5ª Incompleto,7523,Ceramistas (Preparação E Fabricação),1842.7066361941042,-350,2025,2375
2,Até 5ª Incompleto,7524,Vidreiros E Ceramistas (Arte E Decoração),1588.1576712762742,-7,43,50
2,Até 5ª Incompleto,7601,Supervisores Da Indústria Têxtil,6199.148270256484,-36,263,299
2,Até 5ª Incompleto,7602,Supervisores Na Indústria Do Curtimento,1420,-1,0,1
2,Até 5ª Incompleto,7603,Supervisores Na Confecção Do Vestuário,2040.759500644765,-57,95,152
2,Até 5ª Incompleto,7604,Supervisores Na Confecção De Calçados,2352.483061797859,-78,90,168
2,Até 5ª Incompleto,7605,"Supervisores Da Confecção De Artefatos De Tecidos, Couros E Afins",2140.2641363376524,-15,13,28
2,Até 5ª Incompleto,7606,Supervisores Das Artes Gráficas,3880.51462496244,-6,10,16
2,Até 5ª Incompleto,7610,Trabalhadores Polivalentes Das Indústrias Têxteis,2619.629426243753,-80,1097,1177
2,Até 5ª Incompleto,7611,Trabalhadores Da Classificação De Fibras Têxteis E Lavagem De Lã,1314.3462307533523,1,49,48
2,Até 5ª Incompleto,7612,Operadores Da Fiação,2822.7563012639694,-169,388,557
2,Até 5ª Incompleto,7613,Operadores De Tear E Máquinas Similares,3753.8199809363164,-347,641,988
2,Até 5ª Incompleto,7614,"Trabalhadores De Acabamento, Tingimento E Estamparia Das Indústrias Têxteis",4175.4829204954285,-97,420,517
2,Até 5ª Incompleto,7618,Inspetores E Revisores De Produção Têxtil,1708.1221658450163,-99,710,809
2,Até 5ª Incompleto,7620,Trabalhadores Polivalentes Do Curtimento De Couros E Peles,1905.014490552503,118,1134,1016
2,Até 5ª Incompleto,7621,Trabalhadores Da Preparação Do Curtimento De Couros E Peles,1608.780517593422,-10,66,76
2,Até 5ª Incompleto,7622,Trabalhadores Do Curtimento De Couros E Peles,1710.9252257434941,-13,246,259
2,Até 5ª Incompleto,7623,Trabalhadores Do Acabamento De Couros E Peles,2276.5626394662263,-98,384,482
2,Até 5ª Incompleto,7630,Profissionais Polivalentes Da Confecção De Roupas,2005.4845199740103,-126,804,930
2,Até 5ª Incompleto,7631,Trabalhadores Da Preparação Da Confecção De Roupas,1555.8660022698773,-312,2640,2952
2,Até 5ª Incompleto,7632,Operadores De Máquinas Para Costura De Peças Do Vestuário,1535.4498458511396,-1332,7798,9130
2,Até 5ª Incompleto,7633,Operadores De Máquinas Para Bordado E Acabamento De Roupas,1389.0226106870662,-139,940,1079
2,Até 5ª Incompleto,7640,Trabalhadores Polivalentes Da Confecção De Calçados,1433.8362760355062,-1688,3552,5240
2,Até 5ª Incompleto,7641,Trabalhadores Da Preparação Da Confecção De Calçados,1599.977182188982,-169,2936,3105
2,Até 5ª Incompleto,7642,Operadores De Máquinas De Costurar E Montar Calçados,1596.2469652691852,-319,1386,1705
2,Até 5ª Incompleto,7643,Trabalhadores De Acabamento De Calçados,1513.712741434026,-189,721,910
2,Até 5ª Incompleto,7650,Trabalhadores Polivalentes Da Confecção De Artefatos De Tecidos E Couros,1291.8333791333578,-7,46,53
2,Até 5ª Incompleto,7651,"Trabalhadores Da Preparação De Artefatos De Tecidos, Couros E Tapeçaria",1588.968185121861,-10,115,125
2,Até 5ª Incompleto,7652,"Trabalhadores Da Confecção De Artefatos De Tecidos, Couros E Sintéticos",1610.7404365474772,-39,524,563
2,Até 5ª Incompleto,7653,Operadores De Máquinas Na Confecção De Artefatos De  Couro,1512.9015165400342,-13,93,106
2,Até 5ª Incompleto,7654,Trabalhadores Do Acabamento De Artefatos De Tecidos E Couros,1453.8619567241865,-30,82,112
2,Até 5ª Incompleto,7661,Trabalhadores Da Pré-Impressão Gráfica,12274.110974005518,-25,65,90
2,Até 5ª Incompleto,7662,Trabalhadores Da Impressão Gráfica,1909.128459217217,-96,315,411
2,Até 5ª Incompleto,7663,Trabalhadores Do Acabamento Gráfico,2631.003744241008,-88,440,528
2,Até 5ª Incompleto,7664,Trabalhadores De Laboratório Fotográfico E Radiológico,1795.6673294632521,-1,7,8
2,Até 5ª Incompleto,7681,"Trabalhadores De Tecelagem Manual, Tricô, Crochê, Rendas E Afins",1555.1809151585896,-28,49,77
2,Até 5ª Incompleto,7682,Trabalhadores Artesanais Da Confecção De Peças E Tecidos,1461.706080449092,-5,24,29
2,Até 5ª Incompleto,7683,Trabalhadores Artesanais Da Confecção De Calçados E Artefatos De Couros E Peles,2639.6551816625424,13,666,653
2,Até 5ª Incompleto,7686,Trabalhadores Tipográficos Linotipistas E Afins,2087.6216837565103,-4,42,46
2,Até 5ª Incompleto,7687,Encadernadores E Recuperadores De Livros (Pequenos Lotes Ou A Unidade),1715.1930575900608,-6,7,13
2,Até 5ª Incompleto,7701,"Supervisores Em Indústria De Madeira, Mobiliário E Da Carpintaria Veicular",2802.2179889706485,-58,430,488
2,Até 5ª Incompleto,7711,Marceneiros E Afins,1792.087794626762,-183,2155,2338
2,Até 5ª Incompleto,7721,Trabalhadores De Tratamento E Preparação Da Madeira,1567.7685008254787,-214,1675,1889
2,Até 5ª Incompleto,7731,Operadores De Máquinas De Desdobramento Da Madeira,3900.0535189977177,-376,2992,3368
2,Até 5ª Incompleto,7732,Operadores De Máquinas De Aglomeração E Prensagem De Chapas,1562.7212603824098,-22,83,105
2,Até 5ª Incompleto,7733,Operadores De Usinagem Convencional De Madeira,1793.7383701968743,-232,1683,1915
2,Até 5ª Incompleto,7734,Operadores De Máquina De Usinar Madeira (Produção Em Série),1663.999441856764,-72,271,343
2,Até 5ª Incompleto,7735,Operadores De Máquinas De Usinagem De Madeira Cnc,1894.0209171415995,-38,62,100
2,Até 5ª Incompleto,7741,Montadores De Móveis E Artefatos De Madeira,1746.0269709449906,-192,1621,1813
2,Até 5ª Incompleto,7751,Trabalhadores De Arte E  Do Acabamento Em Madeira Do Mobiliário,1560.9810496125006,-25,228,253
2,Até 5ª Incompleto,7764,"Confeccionadores De Artefatos De Madeira, Móveis De Vime E Afins",1477.2411102152666,-18,57,75
2,Até 5ª Incompleto,7771,Carpinteiros Navais,2942.0095567491317,0,7,7
2,Até 5ª Incompleto,7772,Carpinteiros De Carrocerias E Carretas,2167.766531808036,-7,22,29
2,Até 5ª Incompleto,7801,Supervisores De Trabalhadores De Embalagem E Etiquetagem,2079.886568735881,-28,69,97
2,Até 5ª Incompleto,7811,Condutores De Processos Robotizados,1721.1234821520352,6,28,22
2,Até 5ª Incompleto,7813,Operadores De Equipamentos Pilotados Remotamente,2044.1608072916665,2,5,3
2,Até 5ª Incompleto,7817,Trabalhadores Subaquáticos,1879.9728437151227,-4,12,16
2,Até 5ª Incompleto,7821,Operadores De Máquinas E Equipamentos De Elevação,2392.679601823432,-300,2720,3020
2,Até 5ª Incompleto,7822,Operadores De Equipamentos De Movimentação De Cargas,1979.7837839663505,-749,2734,3483
2,Até 5ª Incompleto,7823,Motoristas De Veículos De Pequeno E Médio Porte,2265.896387061417,-1164,9005,10169
2,Até 5ª Incompleto,7824,"Motoristas De Ônibus Urbanos, Metropolitanos E Rodoviários",2614.606025359164,-2110,9630,11740
2,Até 5ª Incompleto,7825,Motoristas De Veículos De Cargas Em Geral,2511.9379581558314,-687,57194,57881
2,Até 5ª Incompleto,7826,Operadores De Veículos Sobre Trilhos E Cabos Aéreos,2215.317652963492,-18,30,48
2,Até 5ª Incompleto,7827,Trabalhadores Aquaviários,2777.983351138864,13,553,540
2,Até 5ª Incompleto,7828,Condutores De Animais E De Veículos De Tração Animal E Pedais,1456.268775571015,2,184,182
2,Até 5ª Incompleto,7831,Trabalhadores De Manobras De Transportes Sobre Trilhos,2437.9457979437047,18,379,361
2,Até 5ª Incompleto,7832,Trabalhadores De Cargas E Descargas De Mercadorias,1622.660841544213,-706,33095,33801
2,Até 5ª Incompleto,7841,Trabalhadores De Embalagem E De Etiquetagem,1540.1137084773045,-717,7002,7719
2,Até 5ª Incompleto,7842,Alimentadores De Linhas De Produção,2022.8508127364448,8653,79474,70821
2,Até 5ª Incompleto,7911,Artesãos,1568.5482405648618,4,50,46
2,Até 5ª Incompleto,8101,"Supervisores De Produção Em Indústrias Químicas, Petroquímicas E Afins",3229.459201597556,-18,13,31
2,Até 5ª Incompleto,8102,Supervisores De Produção Em Indústrias De Transformação De Plásticos E Borrachas,2710.572498321533,-18,23,41
2,Até 5ª Incompleto,8103,"Supervisores De Produção Em Indústrias De Produtos Farmacêuticos, Cosméticos E Afins",1756.75,-2,1,3
2,Até 5ª Incompleto,8110,"Operadores Polivalentes De Equipamentos Em Indústrias Químicas, Petroquímicas E Afins",2056.6829300298923,-25,18,43
2,Até 5ª Incompleto,8111,Operadores De Equipamentos De Moagem E Mistura De Materiais (Tratamentos Químicos E Afins),2200.5009417348674,-58,255,313
2,Até 5ª Incompleto,8112,Operadores De Calcinação E De Tratamentos Químicos De Materiais Radioativos,2348.5842682635557,-194,249,443
2,Até 5ª Incompleto,8113,Operadores De Equipamentos De Filtragem E Separação,1596.9361182395485,-31,133,164
2,Até 5ª Incompleto,8114,"Operadores De Equipamentos De Destilação, Evaporação E Reação",6900.615251433684,-69,173,242
2,Até 5ª Incompleto,8115,Operadores De Equipamentos De Produção E Refino De Petróleo E Gás,1429.7758280436196,3,6,3
2,Até 5ª Incompleto,8116,Operadores De Equipamentos De Coqueificação,1681.9801313563944,-20,85,105
2,Até 5ª Incompleto,8117,"Operadores De Instalações E Máquinas De Produtos Plásticos, De Borracha E Moldadores De Parafinas",1624.6713386989948,-258,1971,2229
2,Até 5ª Incompleto,8118,"Operadores De Máquinas E Instalações De Produtos Farmacêuticos, Cosméticos E Afins",1651.6863726738159,13,304,291
2,Até 5ª Incompleto,8121,Trabalhadores Da Fabricação De Munição E Explosivos Químicos,1309.0644325109565,-30,299,329
2,Até 5ª Incompleto,8131,"Operadores De Processos Das Indústrias De Transformação De Produtos Químicos, Petroquímicos E Afins",1781.3575629099116,-107,699,806
2,Até 5ª Incompleto,8181,Laboratoristas Industriais Auxiliares,3259.329146176293,-64,161,225
2,Até 5ª Incompleto,8201,Supervisores De Produção Em Indústrias Siderúrgicas,2847.7106169980193,-14,20,34
2,Até 5ª Incompleto,8202,Supervisores Na Fabricação De Materiais Para Construção (Vidros E Cerâmicas),2597.364782141359,-48,59,107
2,Até 5ª Incompleto,8211,Operadores De Instalações De Sinterização,1617.9668245673179,12,47,35
2,Até 5ª Incompleto,8212,Operadores De Fornos De Primeira  Fusão E Aciaria,2030.8592557889547,-68,1633,1701
2,Até 5ª Incompleto,8213,Operadores De Equipamentos De Laminação,1884.4809773431793,-55,164,219
2,Até 5ª Incompleto,8214,Operadores De Equipamentos De Acabamento De Chapas E Metais,2731.208695200491,-103,2505,2608
2,Até 5ª Incompleto,8221,Forneiros Metalúrgicos (Segunda Fusão E Reaquecimento),17689.694130443706,-45,134,179
2,Até 5ª Incompleto,8231,"Operadores Na Preparação De Massas Para Abrasivo, Vidro, Cerâmica, Porcelana E Materiais De Construção",1778.9300959608813,31,147,116
2,Até 5ª Incompleto,8232,"Operadores De Equipamentos De Fabricação  E Beneficiamento De Cristais, Vidros, Cerâmicas, Porcelanas, Fibras De Vidro, Abrasivos E Afins",1920.7425815319398,-45,127,172
2,Até 5ª Incompleto,8233,Operadores De Instalações E Equipamentos De Fabricação De Materiais De Construção,1436.8400465409559,-4,3298,3302
2,Até 5ª Incompleto,8281,Trabalhadores Da Fabricação De Cerâmica Estrutural Para Construção,2725.270387969712,-441,4952,5393
2,Até 5ª Incompleto,8301,Supervisores Da Fabricação De Celulose E Papel,2989.3567433076746,-16,9,25
2,Até 5ª Incompleto,8311,Preparadores De Pasta Para Fabricação De Papel,1711.7175325983876,-29,31,60
2,Até 5ª Incompleto,8321,Operadores De Máquinas De Fabricar Papel E Papelão,1791.8287393813043,-107,173,280
2,Até 5ª Incompleto,8331,Operadores De Máquinas Na Fabricação De Produtos De Papel E Papelão,2329.988978093324,-28,264,292
2,Até 5ª Incompleto,8332,Trabalhadores Artesanais De Produtos De Papel E Papelão,2404.4745285232348,22,165,143
2,Até 5ª Incompleto,8401,"Supervisores Da Fabricação De Alimentos, Bebidas E Fumo",2411.9314163127538,-124,155,279
2,Até 5ª Incompleto,8411,"Trabalhadores Da Indústria De Beneficiamento De Grãos, Cereais E Afins",2099.184683904282,-98,658,756
2,Até 5ª Incompleto,8412,Trabalhadores No Beneficiamento Do Sal,7038.936444753624,-28,183,211
2,Até 5ª Incompleto,8413,Trabalhadores Na Fabricação E Refino De Açúcar,7128.977260408833,-125,758,883
2,Até 5ª Incompleto,8414,Trabalhadores Na Fabricação E Conservação De Alimentos,1540.97600244021,-311,4132,4443
2,Até 5ª Incompleto,8415,Trabalhadores Na Pasteurização Do Leite E Na Fabricação De Laticínios  E Afins,1433.480020410016,-72,1010,1082
2,Até 5ª Incompleto,8416,"Trabalhadores Na Industrialização De Café, Cacau, Mate E De Produtos Afins",1684.1195109744185,-22,73,95
2,Até 5ª Incompleto,8417,"Trabalhadores Na Fabricação De Cachaça, Cerveja, Vinhos E Outras Bebidas",1958.6319931784337,-16,450,466
2,Até 5ª Incompleto,8418,"Operadores De Equipamentos Na Fabricação De Pães, Massas Alimentícias, Doces, Chocolates E Achocolatados",1838.9295487748266,-218,481,699
2,Até 5ª Incompleto,8421,Cigarreiros E Beneficiadores De Fumo,1583.5355734318935,429,5800,5371
2,Até 5ª Incompleto,8422,Charuteiros,1766.7385163483796,1,12,11
2,Até 5ª Incompleto,8481,Trabalhadores Artesanais Na Conservação De Alimentos,1568.7300553869338,-94,356,450
2,Até 5ª Incompleto,8482,Trabalhadores Artesanais Na Pasteurização Do Leite E Na Fabricação De Laticínios E Afins,1395.8458247325882,-76,158,234
2,Até 5ª Incompleto,8483,"Padeiros, Confeiteiros E Afins",1865.1808500539823,-588,3655,4243
2,Até 5ª Incompleto,8484,Trabalhadores Na Degustação E Classificação De Grãos E Afins,1763.81670031157,-54,171,225
2,Até 5ª Incompleto,8485,Magarefes E Afins,1594.5125161699102,-2207,24766,26973
2,Até 5ª Incompleto,8486,Trabalhadores Artesanais Na Indústria Do Fumo,1359.815232220818,4,954,950
2,Até 5ª Incompleto,8601,Supervisores Da Produção De Utilidades,3253.367497201269,-27,157,184
2,Até 5ª Incompleto,8611,"Operadores De Instalações De Geração E Distribuição De Energia Elétrica, Hidráulica, Térmica Ou Nuclear",1969.506910108067,-21,58,79
2,Até 5ª Incompleto,8612,Operadores De Instalações De Distribuição De Energia Elétrica,2070.10293463212,19,49,30
2,Até 5ª Incompleto,8621,Operadores De Máquinas A Vapor E Utilidades,3052.110163378328,-1115,5769,6884
2,Até 5ª Incompleto,8622,"Operadores De Instalações De Captação, Tratamento E Distribuição De Água",1808.161708299594,-73,210,283
2,Até 5ª Incompleto,8623,Operadores De Instalações De Captação E Esgotos,2297.0008849302258,-87,445,532
2,Até 5ª Incompleto,8624,"Operadores De Instalações De Extração, Processamento, Envasamento E Distribuição De Gases",1944.3019984654018,-15,10,25
2,Até 5ª Incompleto,8625,Operadores De Instalações De Refrigeração E Ar-Condicionado,1955.858232753837,-19,57,76
2,Até 5ª Incompleto,9101,"Supervisores Em Serviços De Reparação E Manutenção De Máquinas E Equipamentos Industriais, Comerciais E Residenciais",4926.920518684322,-123,280,403
2,Até 5ª Incompleto,9102,Supervisores Em Serviços De Reparação E Manutenção Veicular,2649.8711507085613,-35,67,102
2,Até 5ª Incompleto,9109,"Supervisores De Outros Trabalhadores De Serviços De Reparação, Conservação E Manutenção",3455.689514695552,-23,25,48
2,Até 5ª Incompleto,9111,"Mecânicos De Manutenção De Bombas, Motores, Compressores E Equipamentos De Transmissão",1993.5045808422785,-14,540,554
2,Até 5ª Incompleto,9112,Mecânicos De Manutenção E Instalação De Aparelhos De  Climatização E Refrigeração,1843.6392898881033,-6,442,448
2,Até 5ª Incompleto,9113,Mecânicos De Manutenção De Máquinas Industriais,3135.4844119180616,-387,3699,4086
2,Até 5ª Incompleto,9131,Mecânicos De Manutenção De Máquinas Pesadas E Equipamentos Agrícolas,3165.509017506451,-141,1511,1652
2,Até 5ª Incompleto,9141,Mecânicos De Manutenção Aeronáutica,2100.159570011092,-12,39,51
2,Até 5ª Incompleto,9142,Mecânicos De Manutenção De Motores E Equipamentos Navais,2205.46963936942,0,14,14
2,Até 5ª Incompleto,9143,Mecânicos De Manutenção Metroferroviária,7109.416977391098,-25,103,128
2,Até 5ª Incompleto,9144,Mecânicos De Manutenção De Veículos Automotores,2674.6463307115114,-463,5960,6423
2,Até 5ª Incompleto,9151,Técnicos Em Manutenção E Reparação De Instrumentos De Medição E Precisão,1823.5806097292432,-3,23,26
2,Até 5ª Incompleto,9152,Restauradores De Instrumentos Musicais,1861.3333333333335,0,2,2
2,Até 5ª Incompleto,9153,Técnicos Em Manutenção E Reparação De Equipamentos Biomédicos,1426.6745383522727,-4,4,8
2,Até 5ª Incompleto,9191,Lubrificadores,2853.992337201558,-156,1079,1235
2,Até 5ª Incompleto,9192,"Trabalhadores De Manutenção De Roçadeiras, Motoserras E Similares",1867.54235246077,-58,473,531
2,Até 5ª Incompleto,9193,Mecânicos De Manutenção De Bicicletas E Equipamentos Esportivos E De Ginástica,2132.3406350068904,-11,138,149
2,Até 5ª Incompleto,9501,"Supervisores De Manutenção Eletroeletrônica Industrial, Comercial E Predial",3064.7354747278846,-104,203,307
2,Até 5ª Incompleto,9502,Supervisores De Manutenção Eletroeletrônica Veicular,2693.2018243963066,-7,24,31
2,Até 5ª Incompleto,9503,Supervisores De Manutenção Eletromecânica,4772.624928307911,-15,24,39
2,Até 5ª Incompleto,9511,Eletricistas De Manutenção Eletroeletrônica,2720.1883878259505,-207,1556,1763
2,Até 5ª Incompleto,9513,Instaladores E Mantenedores De Sistemas Eletroeletrônicos De Segurança,1522.8490255780607,-13,195,208
2,Até 5ª Incompleto,9531,"Eletricistas Eletrônicos De Manutenção Veicular (Aérea, Terrestre E Naval)",3070.979905959537,-94,528,622
2,Até 5ª Incompleto,9541,"Instaladores E Mantenedores Eletromecânicos De Elevadores, Escadas E Portas Automáticas",2166.567217397157,-79,381,460
2,Até 5ª Incompleto,9542,Reparadores De Aparelhos Eletrodomésticos,1461.37989063752,-18,11,29
2,Até 5ª Incompleto,9543,Reparadores De Equipamentos De Escritório,1409.6499755859375,1,3,2
2,Até 5ª Incompleto,9911,Conservadores De Vias Permanentes (Trilhos),1944.9179525841507,50,1326,1276
2,Até 5ª Incompleto,9912,Mantenedores De Equipamentos De Parques De Diversões E Similares,1504.6241743607955,-1,27,28
2,Até 5ª Incompleto,9913,Reparadores De Carrocerias De Veículos,1926.0997647839376,-185,1040,1225
2,Até 5ª Incompleto,9921,Trabalhadores Elementares De Serviços De Manutenção Veicular,1903.2857779415003,-160,2343,2503
2,Até 5ª Incompleto,9922,Trabalhadores Operacionais De Conservação De Vias Permanentes (Exceto Trilhos),1835.6376249623324,43,12354,12311
3,5ª Completo Fundamental,0000,Não especificado,1232.820235833889,87,173,86
3,5ª Completo Fundamental,0101,Oficiais Generais Das Forças Armadas,1563.7015753678106,4,33,29
3,5ª Completo Fundamental,0102,Oficiais Das Forças Armadas,1451.1199951171875,1,3,2
3,5ª Completo Fundamental,0103,Praças Das Forças Armadas,1232.0261986142114,-1,4,5
3,5ª Completo Fundamental,0301,Oficiais Superiores Do Corpo De Bombeiros Militar,1258.1050048828124,0,5,5
3,5ª Completo Fundamental,1111,Legisladores,1665.8705512152778,11,15,4
3,5ª Completo Fundamental,1112,Dirigentes Gerais Da Administração Pública,4728.097500610352,0,11,11
3,5ª Completo Fundamental,1113,Magistrados,4184,-1,0,1
3,5ª Completo Fundamental,1114,Dirigentes Do Serviço Público,3569.249257405599,2,32,30
3,5ª Completo Fundamental,1115,Gestores Públicos,1951.1070068359375,1,4,3
3,5ª Completo Fundamental,1142,Dirigentes E Administradores De Entidades Patronais E Dos Trabalhadores E De Outros Interesses Sócioeconômicos,3413.326646592882,-4,3,7
3,5ª Completo Fundamental,1210,Diretores Gerais,1847.7661477951776,-23,120,143
3,5ª Completo Fundamental,1221,"Diretores De Produção E Operações Em Empresa Agropecuária, Pesqueira , Aqüícola E Florestal",1515.5849853515624,2,9,7
3,5ª Completo Fundamental,1222,"Diretores De Produção E Operações Em Empresa Da Indústria Extrativa, Transformação E De Serviços De Utilidade Pública",1216.8833414713542,-1,1,2
3,5ª Completo Fundamental,1223,Diretores De Operações De Obras Em Empresa De Construção,2764.3238619290864,1,7,6
3,5ª Completo Fundamental,1224,Diretores De Operações Em Empresa Do Comércio,1911.2400076729912,-7,0,7
3,5ª Completo Fundamental,1225,"Diretores De Serviços De Turismo, De Alojamento E De Alimentação",1848.8799926757813,-4,1,5
3,5ª Completo Fundamental,1226,"Diretores De Operações De Serviços Em Empresa De Armazenamento, De Transporte E De Telecomunicação",6068.18065592448,0,4,4
3,5ª Completo Fundamental,1227,Diretores De Operações De Serviços Em Instituição De Intermediação Financeira,1777.800048828125,-1,0,1
3,5ª Completo Fundamental,1231,Diretores Administrativos E Financeiros,3116.014192093639,-40,61,101
3,5ª Completo Fundamental,1232,Diretores De Recursos Humanos E Relações De Trabalho,1263.6672696200285,5,8,3
3,5ª Completo Fundamental,1233,Diretores De Comercialização E Marketing,3202.842254638672,-1,10,11
3,5ª Completo Fundamental,1234,Diretores De Suprimentos E Afins,9975,1,1,0
3,5ª Completo Fundamental,1236,Diretores De Tecnologia Da Informação,2461.860107421875,-1,0,1
3,5ª Completo Fundamental,1238,Diretores De Manutenção,2129.4081268310547,-4,6,10
3,5ª Completo Fundamental,1311,"Diretores E Gerentes De Operações Em Empresa De Serviços Pessoais, Sociais E Culturais",2015.2328500217864,-12,61,73
3,5ª Completo Fundamental,1312,"Gestores E Especialistas De Operações Em Empresas, Secretarias E Unidades De Serviços De Saúde",6057.983753022693,-5,11,16
3,5ª Completo Fundamental,1313,Diretores E Gerentes De Instituição De Serviços Educacionais,3768.53245578342,-10,3,13
3,5ª Completo Fundamental,1411,"Gerentes De Produção E Operações Em Empresa Agropecuária, Pesqueira, Aqüícola E Florestal",2593.9358731354246,-115,567,682
3,5ª Completo Fundamental,1412,"Gerentes De Produção E Operações Em Empresa Da Indústria Extrativa, De Transformação E De Serviços De Utilidade Pública",2884.27765544199,-204,460,664
3,5ª Completo Fundamental,1413,Gerentes De Obras Em Empresa De Construção,3239.096266751084,-17,96,113
3,5ª Completo Fundamental,1414,Gerentes De Operações Comerciais E De Assistência Técnica,2071.6721385326573,-496,1121,1617
3,5ª Completo Fundamental,1415,"Gerentes De Operações De Serviços Em Empresa De Turismo, De Alojamento E Alimentação",2778.3241984894385,-211,251,462
3,5ª Completo Fundamental,1416,"Gerentes De Operações De Serviços Em Empresa De Transporte, De Comunicação E De Logística (Armazenagem E Distribuição)",2691.5925916140254,-105,120,225
3,5ª Completo Fundamental,1417,Gerentes De Operações De Serviços Em Instituição De Intermediação Financeira,5465.606640043713,-8,10,18
3,5ª Completo Fundamental,1418,Gerentes Operacionais Da Aviação Civil,3837.3333333333335,0,2,2
3,5ª Completo Fundamental,1421,"Gerentes Administrativos, Financeiros, De Riscos E Afins",3598.7217988230104,-325,696,1021
3,5ª Completo Fundamental,1422,Gerentes De Recursos Humanos E De Relações Do Trabalho,2230.8159139430268,-7,43,50
3,5ª Completo Fundamental,1423,"Gerentes De Comercialização, Marketing E Comunicação",3404.9747686729534,-285,495,780
3,5ª Completo Fundamental,1424,Gerentes De Suprimentos E Afins,5206.984758972491,-26,44,70
3,5ª Completo Fundamental,1425,Gerentes De Tecnologia Da Informação,3549.3504063678306,-13,22,35
3,5ª Completo Fundamental,1426,Gerentes De Pesquisa E Desenvolvimento E Afins,5794.05635209517,-5,3,8
3,5ª Completo Fundamental,1427,Gerentes De Manutenção E Afins,3788.746613139491,-46,55,101
3,5ª Completo Fundamental,2012,Profissionais Da Metrologia,6495.539957682292,-4,0,4
3,5ª Completo Fundamental,2021,"Engenheiros De Controle E Automação, Engenheiros Mecatrônicos E Afins",7541.25,1,5,4
3,5ª Completo Fundamental,2030,Pesquisadores Das Ciências Biológicas,1507.5,0,2,2
3,5ª Completo Fundamental,2031,Pesquisadores Das Ciências Naturais E Exatas,1709.6800048828125,0,3,3
3,5ª Completo Fundamental,2032,Pesquisadores De Engenharia E Tecnologia,1000,0,2,2
3,5ª Completo Fundamental,2034,Pesquisadores Das Ciências Da Agricultura,0,1,1,0
3,5ª Completo Fundamental,2035,Pesquisadores Das Ciências Sociais E Humanas,1220,0,1,1
3,5ª Completo Fundamental,2111,Profissionais Da Matemática,1830.3399658203125,-2,1,3
3,5ª Completo Fundamental,2122,Engenheiros Em Computação,15032.2900390625,-1,0,1
3,5ª Completo Fundamental,2123,Administradores De Tecnologia Da Informação,2321.94031270345,5,15,10
3,5ª Completo Fundamental,2124,Analistas De Tecnologia Da Informação,5532.4150727840315,-2,91,93
3,5ª Completo Fundamental,2132,Químicos,2106.6554812476747,-7,5,12
3,5ª Completo Fundamental,2134,"Geólogos, Oceanógrafos, Geofísicos E Afins",2953.6666666666665,1,2,1
3,5ª Completo Fundamental,2140,Engenheiros Ambientais E Afins,4240.6808527166195,1,12,11
3,5ª Completo Fundamental,2141,Arquitetos E Urbanistas,1256.625,-2,0,2
3,5ª Completo Fundamental,2142,Engenheiros Civis E Afins,3398.191239929199,0,47,47
3,5ª Completo Fundamental,2143,"Engenheiros Eletricistas, Eletrônicos E Afins",4096.302669671275,-10,40,50
3,5ª Completo Fundamental,2144,Engenheiros Mecânicos E Afins,2613.3958374023437,0,8,8
3,5ª Completo Fundamental,2145,Engenheiros Químicos E Afins,1411.75,1,1,0
3,5ª Completo Fundamental,2146,"Engenheiros Metalurgistas, De Materiais E Afins",3000,-1,0,1
3,5ª Completo Fundamental,2147,Engenheiros De Minas E Afins,11120.937109375,2,4,2
3,5ª Completo Fundamental,2149,"Engenheiros De Produção, Qualidade, Segurança E Afins",4927.301477167039,-4,16,20
3,5ª Completo Fundamental,2151,Oficiais De Convés E Afins,10147.121186828614,-4,19,23
3,5ª Completo Fundamental,2152,Oficiais De Máquinas Da Marinha Mercante,1778.0805799696182,-3,3,6
3,5ª Completo Fundamental,2153,Profissionais Da Pilotagem Aeronáutica,3623.9373586554275,-2,9,11
3,5ª Completo Fundamental,2211,Biólogos E Afins,1488.975,2,11,9
3,5ª Completo Fundamental,2212,Biomédicos,2292.5650024414063,-2,3,5
3,5ª Completo Fundamental,2221,Engenheiros Agrossilvipecuários,20847.321761131287,-7,17,24
3,5ª Completo Fundamental,2222,Engenheiros De Alimentos E Afins,2500,1,1,0
3,5ª Completo Fundamental,2232,Cirurgiões-Dentistas,2683.0133463541665,1,5,4
3,5ª Completo Fundamental,2233,Veterinários E Zootecnistas,2424.049766903832,-6,2,8
3,5ª Completo Fundamental,2234,Farmacêuticos,3272.290707542783,3,41,38
3,5ª Completo Fundamental,2235,Enfermeiros E Afins,4037.5715745713974,-3,26,29
3,5ª Completo Fundamental,2236,Fisioterapeutas,2522.1550027598505,-6,9,15
3,5ª Completo Fundamental,2237,Nutricionistas,1799.2176979670448,2,41,39
3,5ª Completo Fundamental,2238,Fonoaudiólogos,2004.4727228338068,-9,1,10
3,5ª Completo Fundamental,2239,"Terapeutas Ocupacionais, Ortoptistas E Psicomotricistas",2606.8571428571427,1,4,3
3,5ª Completo Fundamental,2241,Profissionais Da Educação Física,2112.2188047399623,-19,35,54
3,5ª Completo Fundamental,2251,Médicos Clínicos,3000.1357523600263,-15,9,24
3,5ª Completo Fundamental,2252,Médicos Em Especialidades Cirúrgicas,4066.1800130208335,-5,1,6
3,5ª Completo Fundamental,2253,Médicos Em Medicina Diagnóstica E Terapêutica,5850,-1,0,1
3,5ª Completo Fundamental,2311,Professores De Nível Superior Na Educação Infantil,2067.1287434895835,-10,10,20
3,5ª Completo Fundamental,2312,Professores De Nível Superior Do Ensino Fundamental (Primeira A Quarta Séries),1891.8103226786075,-24,25,49
3,5ª Completo Fundamental,2313,Professores De Nível Superior No Ensino Fundamental De Quinta A Oitava Série,1259.6356671537671,-10,14,24
3,5ª Completo Fundamental,2321,Professores Do Ensino Médio,1272.812975285848,3,17,14
3,5ª Completo Fundamental,2331,Professores Do Ensino Profissional,1435,-1,0,1
3,5ª Completo Fundamental,2332,Instrutores De Ensino Profissional,2676.964608431619,-22,34,56
3,5ª Completo Fundamental,2341,"Professores De Matemática, Estatística E Informática Do Ensino Superior",2747.93994140625,-1,0,1
3,5ª Completo Fundamental,2343,"Professores De Arquitetura E Urbanismo, Engenharia, Geofísica E Geologia Do Ensino Superior",0,-1,0,1
3,5ª Completo Fundamental,2344,Professores De Ciências Biológicas E Da Saúde Do Ensino Superior,860.3131332397461,2,8,6
3,5ª Completo Fundamental,2345,Professores Na Área De Formação Pedagógica Do Ensino Superior,3203.3133998446992,-21,0,21
3,5ª Completo Fundamental,2346,Professores Nas Áreas De Língua E Literatura Do Ensino Superior,2030.9784673055012,2,15,13
3,5ª Completo Fundamental,2347,Professores De Ciências Humanas Do Ensino Superior,534.8666585286459,-4,1,5
3,5ª Completo Fundamental,2348,"Professores De Ciências Econômicas, Administrativas E Contábeis Do Ensino Superior",3403.2999877929688,-2,1,3
3,5ª Completo Fundamental,2349,Professores De Artes Do Ensino Superior,233.2800006866455,0,3,3
3,5ª Completo Fundamental,2392,Professores De Educação Especial,1794.3416748046875,-2,2,4
3,5ª Completo Fundamental,2394,"Programadores, Avaliadores E Orientadores De Ensino",1911.753257413267,-31,49,80
3,5ª Completo Fundamental,2410,Advogados,2853.3767457125477,-12,10,22
3,5ª Completo Fundamental,2412,Procuradores E Advogados Públicos,783.75,-2,1,3
3,5ª Completo Fundamental,2413,Tabeliães E Registradores,4243.051676432291,-2,1,3
3,5ª Completo Fundamental,2512,Economistas,3177.6988098144534,-3,8,11
3,5ª Completo Fundamental,2515,Psicólogos E Psicanalistas,2054.586629231771,-3,6,9
3,5ª Completo Fundamental,2516,Assistentes Sociais E Economistas Domésticos,1875.3372328016494,3,11,8
3,5ª Completo Fundamental,2521,Administradores,2308.65229459938,-67,222,289
3,5ª Completo Fundamental,2522,Contadores E Afins,3167.4288502086292,-14,50,64
3,5ª Completo Fundamental,2523,Secretárias(Os) Executivas(Os) E Afins,1976.6455489533932,-77,234,311
3,5ª Completo Fundamental,2524,Profissionais De Recursos Humanos,2542.848876953125,-6,46,52
3,5ª Completo Fundamental,2525,Profissionais De Administração Ecônomico-Financeira,2199.843165530208,-27,14,41
3,5ª Completo Fundamental,2526,Profissionais Da Administração Dos Serviços De Segurança,2968.1659912109376,-3,1,4
3,5ª Completo Fundamental,2527,"Profissionais De Planejamento, Programação E Controles Logisticos",2642.412955277054,4,11,7
3,5ª Completo Fundamental,2531,Profissionais De Publicidade,5846.965853936374,3,39,36
3,5ª Completo Fundamental,2532,Profissionais De Comercializacão E Consultoria De Serviços Bancários,3257.790991828555,-22,23,45
3,5ª Completo Fundamental,2533,"Corretores De Valores, Ativos Financeiros, Mercadorias E Derivativos",1454.4426513671874,-3,6,9
3,5ª Completo Fundamental,2534,Profissionais De Mídias Digitais E Afins,11102.5,2,5,3
3,5ª Completo Fundamental,2543,Auditores Fiscais Do Trabalho,7145.766096309333,51,218,167
3,5ª Completo Fundamental,2544,Fiscais De Tributos Estaduais E Municipais,2943.670659383138,-3,4,7
3,5ª Completo Fundamental,2545,Profissionais Da Fiscalização De Atividades Urbanas,1938.8822651524697,-13,9,22
3,5ª Completo Fundamental,2611,Profissionais Do Jornalismo,1997.0084075906161,-11,34,45
3,5ª Completo Fundamental,2612,Profissionais Da Informação,1987.7046838185142,-3,6,9
3,5ª Completo Fundamental,2613,Arquivistas E Museólogos,1409.6425136990017,0,12,12
3,5ª Completo Fundamental,2614,"Filólogos,Tradutores ,Intérpretes E Afins",2844.75,-1,1,2
3,5ª Completo Fundamental,2615,Profissionais Da Escrita,3442.9049479166665,0,2,2
3,5ª Completo Fundamental,2616,Editores,1600,1,1,0
3,5ª Completo Fundamental,2617,"Locutores, Comentaristas E Repórteres De Mídias Audiovisuais",1430.72961145401,-22,42,64
3,5ª Completo Fundamental,2618,Fotógrafos Profissionais,1780.500937906901,-3,10,13
3,5ª Completo Fundamental,2621,Produtores Artísticos E Culturais,2370.4599965413413,-3,3,6
3,5ª Completo Fundamental,2622,Diretores De Espetáculos E Afins,2650,2,2,0
3,5ª Completo Fundamental,2623,Cenógrafos,2110.074384689331,1,7,6
3,5ª Completo Fundamental,2624,"Artistas Visuais,Desenhistas Industriais E Conservadores-Restauradores De Bens Culturais",8678.540115356445,7,75,68
3,5ª Completo Fundamental,2625,Atores,6144.5,-2,1,3
3,5ª Completo Fundamental,2626,"Músicos Compositores, Arranjadores, Regentes E Musicólogos",1919.368882921007,-4,1,5
3,5ª Completo Fundamental,2627,Músicos Intérpretes,2055.8956978537817,-11,3,14
3,5ª Completo Fundamental,2628,Artistas Da Dança (Exceto Dança Tradicional E Popular),1419.5865101019542,-5,7,12
3,5ª Completo Fundamental,2629,Designer De Interiores De Nível Superior,1700,1,1,0
3,5ª Completo Fundamental,2631,"Ministros De Culto, Missionários, Teólogos E Profissionais Assemelhados",1998.183369954427,-4,1,5
3,5ª Completo Fundamental,2711,Chefes De Cozinha E Afins,3014.5186762833478,-125,207,332
3,5ª Completo Fundamental,3001,Técnicos Em Mecatrônica,2715.9130126953123,-5,3,8
3,5ª Completo Fundamental,3003,Técnicos Em Eletromecânica,2338.3451933684173,-4,52,56
3,5ª Completo Fundamental,3011,Técnicos De Laboratório Industrial,1756.4207559703918,-13,372,385
3,5ª Completo Fundamental,3111,Técnicos Químicos,1742.5291606516078,-23,14,37
3,5ª Completo Fundamental,3112,"Técnicos De Produção De Indústrias Químicas, Petroquímicas, Refino De Petróleo, Gás E Afins",1120.385707310268,3,5,2
3,5ª Completo Fundamental,3113,"Técnicos Em Materiais, Produtos Cerâmicos E Vidros",2376.7500610351563,-2,0,2
3,5ª Completo Fundamental,3114,Técnicos Em Fabricação De Produtos Plásticos E De Borracha,1707.3791327811227,-21,69,90
3,5ª Completo Fundamental,3115,"Técnicos Em Controle Ambiental, Utilidades E Tratamento De Efluentes",1876.5936166933677,-15,26,41
3,5ª Completo Fundamental,3116,Técnicos Têxteis,2147.6646980406745,-10,5,15
3,5ª Completo Fundamental,3117,Coloristas,2320.7028619542243,-147,681,828
3,5ª Completo Fundamental,3121,Técnicos Em Construção Civil (Edificações),2443.607212653527,-16,200,216
3,5ª Completo Fundamental,3122,Técnicos Em Construção Civil (Obras De Infraestrutura),3085.0530432844153,11,108,97
3,5ª Completo Fundamental,3123,Técnicos Em Geomática,2828.1832791162915,-24,728,752
3,5ª Completo Fundamental,3131,Técnicos Em Eletricidade E Eletrotécnica,2447.921341904626,-152,509,661
3,5ª Completo Fundamental,3132,Técnicos Em Eletrônica,1911.6244136519856,-36,266,302
3,5ª Completo Fundamental,3133,Técnicos Em Telecomunicações,1588.7132805097942,-19,222,241
3,5ª Completo Fundamental,3134,Técnicos Em Calibração E Instrumentação,5399.772137929903,-96,200,296
3,5ª Completo Fundamental,3135,Técnicos Em Fotônica,1539.7563187448602,-6,35,41
3,5ª Completo Fundamental,3141,"Técnicos Mecânicos Na Fabricação E Montagem De Máquinas, Sistemas E Instrumentos",2021.86383810749,-44,390,434
3,5ª Completo Fundamental,3142,Técnicos Mecânicos (Ferramentas),2291.927012416295,-8,17,25
3,5ª Completo Fundamental,3143,Técnicos Em Mecânica Veicular,2227.677137340199,1,33,32
3,5ª Completo Fundamental,3144,"Técnicos Mecânicos Na Manutenção De Máquinas, Sistemas E Instrumentos",2054.569779290675,-18,123,141
3,5ª Completo Fundamental,3146,Técnicos Em Metalurgia (Estruturas Metálicas),8862.835364438342,1,54,53
3,5ª Completo Fundamental,3147,Técnicos Em Siderurgia,3098.000484890408,-1,9,10
3,5ª Completo Fundamental,3148,Especialistas Em Inspeções Industriais,6855.950327555338,21,31,10
3,5ª Completo Fundamental,3161,Técnicos Em Geologia,2795.966872970779,8,24,16
3,5ª Completo Fundamental,3163,Técnicos Em Mineração,3947.9136482007575,2,9,7
3,5ª Completo Fundamental,3171,Técnicos De Desenvolvimento De Sistemas E Aplicações,3170.799836941479,-3,39,42
3,5ª Completo Fundamental,3172,Técnicos De Suporte E Monitoração Ao Usuário De Tecnologia Da Informação.,1468.1935242607478,-11,107,118
3,5ª Completo Fundamental,3180,"Desenhistas Técnicos, Em Geral",2457.5934760199652,-15,7,22
3,5ª Completo Fundamental,3181,Desenhistas Técnicos Da Construção Civil E Arquitetura,2869.870495605469,1,16,15
3,5ª Completo Fundamental,3182,Desenhistas Técnicos Da Mecânica,1033.3148148148148,5,16,11
3,5ª Completo Fundamental,3183,"Desenhistas Técnicos Em Eletricidade, Eletrônica, Eletromecânica, Calefação, Ventilação E Refrigeração",1669.0592935350205,4,13,9
3,5ª Completo Fundamental,3184,Desenhistas Técnicos De Produtos E Serviços Diversos,2315.32709757487,-9,13,22
3,5ª Completo Fundamental,3185,Desenhistas Projetistas De Construção Civil E Arquitetura,2973.7267191426736,-1,18,19
3,5ª Completo Fundamental,3186,Desenhistas Projetistas Da Mecânica,3430.6888766818574,-8,2,10
3,5ª Completo Fundamental,3187,Desenhistas Projetistas Da Eletrônica,5256.403340657552,2,4,2
3,5ª Completo Fundamental,3188,Desenhistas Projetistas E Modelistas De Produtos E Serviços Diversos,2408.5917959092003,-37,57,94
3,5ª Completo Fundamental,3191,Técnicos Do Vestuário,2246.606462751116,-7,1,8
3,5ª Completo Fundamental,3192,Técnicos Do Mobiliário E Afins,2491.460986328125,0,5,5
3,5ª Completo Fundamental,3201,Técnicos Em Biologia,1763.0638333834136,1,7,6
3,5ª Completo Fundamental,3211,Técnicos Agrícolas,2217.0709078411724,-84,107,191
3,5ª Completo Fundamental,3212,Técnicos Florestais,1764.6227614483907,-23,233,256
3,5ª Completo Fundamental,3213,Técnicos Em Aqüicultura,1568.301513671875,-7,5,12
3,5ª Completo Fundamental,3221,Tecnólogos E Técnicos Em Terapias Complementares E Estéticas,1933.5917118553698,-23,38,61
3,5ª Completo Fundamental,3222,Técnicos E Auxiliares De Enfermagem,1804.6687979830704,-83,429,512
3,5ª Completo Fundamental,3223,Técnicos Em Óptica E Optometria,1704.8235648018974,-2,6,8
3,5ª Completo Fundamental,3224,Técnicos De Odontologia,1520.0812172327085,-34,112,146
3,5ª Completo Fundamental,3225,Técnicos Em Próteses Ortopédicas,2434.08798828125,-1,2,3
3,5ª Completo Fundamental,3226,Técnicos De Imobilizações Ortopédicas,1667.1800028483074,-8,2,10
3,5ª Completo Fundamental,3231,Técnicos Em Pecuária,1635.5770338792067,-1,32,33
3,5ª Completo Fundamental,3241,Tecnólogos E Técnicos Em Métodos De Diagnósticos E Terapêutica,2020.7215647627668,6,27,21
3,5ª Completo Fundamental,3242,Técnicos De Laboratórios De Saúde E Bancos De Sangue,2072.616907919607,0,16,16
3,5ª Completo Fundamental,3250,"Enólogos, Perfumistas E Aromistas",1430.4879964192708,3,9,6
3,5ª Completo Fundamental,3251,Técnico Em Farmácia E Em Manipulação Farmacêutica,1828.8918034954413,-5,25,30
3,5ª Completo Fundamental,3252,"Técnicos Em Produção, Conservação  E De Qualidade De Alimentos",1730.1216213814946,-59,135,194
3,5ª Completo Fundamental,3253,Técnicos De Apoio À Biotecnologia,1536.2266438802083,-3,0,3
3,5ª Completo Fundamental,3281,Técnicos Em Necrópsia E Taxidermistas,2461.0499877929688,0,1,1
3,5ª Completo Fundamental,3311,Professores De Nível Médio Na Educação Infantil,1542.3664665278015,-69,272,341
3,5ª Completo Fundamental,3312,Professores De Nível Médio No Ensino Fundamental,8874.629149409702,9,24,15
3,5ª Completo Fundamental,3313,Professores De Nível Médio No Ensino Profissionalizante,537.1771414620536,-1,5,6
3,5ª Completo Fundamental,3321,Professores Leigos No Ensino Fundamental,686.4117647058823,-7,5,12
3,5ª Completo Fundamental,3322,Professores Práticos No Ensino Profissionalizante,1255.483984375,-1,2,3
3,5ª Completo Fundamental,3331,Instrutores E Professores De Cursos Livres,1756.7377246253188,-75,112,187
3,5ª Completo Fundamental,3341,Inspetores De Alunos E Afins,1389.0617672141423,-105,928,1033
3,5ª Completo Fundamental,3411,"Pilotos De Aviação Comercial, Mecânicos De Vôo E Afins",4576.358072916666,-1,8,9
3,5ª Completo Fundamental,3412,"Técnicos Marítimos, Fluviários E Pescadores De Convés",2390.808178548441,-33,265,298
3,5ª Completo Fundamental,3413,Técnicos Marítimos E Fluviários De Máquinas,4225.526211685156,-31,132,163
3,5ª Completo Fundamental,3421,Especialistas Em Logística De Transportes,3094.5346935824264,-14,305,319
3,5ª Completo Fundamental,3422,Despachantes Aduaneiros,5845.884235893082,3,57,54
3,5ª Completo Fundamental,3423,Técnicos Em Transportes Rodoviários,4112.383290773326,-291,282,573
3,5ª Completo Fundamental,3424,Técnicos Em Transportes Metroferroviários,1739.9015647590936,-20,26,46
3,5ª Completo Fundamental,3425,Técnicos Em Transportes Aéreos,1852.406016423152,-14,14,28
3,5ª Completo Fundamental,3426,Técnicos Em Transportes Por Vias Navegáveis E Operações Portuárias,3004.066138226053,-6,9,15
3,5ª Completo Fundamental,3511,Técnicos Em Contabilidade,1878.1458812785052,-3,13,16
3,5ª Completo Fundamental,3513,Técnicos Em Administração,1952.8270749990006,-25,23,48
3,5ª Completo Fundamental,3514,Serventuários Da Justiça E Afins,2900.1381927512402,-28,35,63
3,5ª Completo Fundamental,3515,"Técnicos Em Secretariado, Taquígrafos E Estenotipistas",1425.1041613822374,1,135,134
3,5ª Completo Fundamental,3516,Técnicos Em Segurança Do Trabalho,6397.193854969218,-7,322,329
3,5ª Completo Fundamental,3517,Técnicos De Seguros E Afins,1924.0163566164083,-28,39,67
3,5ª Completo Fundamental,3522,Agentes Da Saúde E Do Meio Ambiente,3480.186975111041,-42,171,213
3,5ª Completo Fundamental,3523,Agentes  Fiscais Metrológicos E De Qualidade,2399.7227544148764,-11,38,49
3,5ª Completo Fundamental,3524,Profissionais De Direitos Autorais E De Avaliacão De Produtos Dos Meios De Comunicação,1725.4500122070313,-2,0,2
3,5ª Completo Fundamental,3532,Técnicos Em Operações E Serviços Bancários,3846.8214181082585,-10,5,15
3,5ª Completo Fundamental,3541,Especialistas Em Promoção De Produtos E Vendas,2068.955814515018,-121,1201,1322
3,5ª Completo Fundamental,3542,Compradores,3109.6132338045486,-52,92,144
3,5ª Completo Fundamental,3543,Analistas De Comércio Exterior,3273.8455403645835,3,6,3
3,5ª Completo Fundamental,3544,Leiloeiros E Avaliadores,1695.8411342075892,-4,9,13
3,5ª Completo Fundamental,3545,Corretores De Seguros,1342,-1,0,1
3,5ª Completo Fundamental,3546,Corretores De Imóveis E De Grãos,1390.6400048828125,-3,11,14
3,5ª Completo Fundamental,3547,Representantes Comerciais Autônomos,1573.210907907197,5,19,14
3,5ª Completo Fundamental,3548,Técnicos Em Serviços De Turismo E Organização De Eventos,1936.4404821394091,-12,61,73
3,5ª Completo Fundamental,3711,Técnicos Em Biblioteconomia,1306.3083360460068,-1,9,10
3,5ª Completo Fundamental,3713,Técnicos Em Artes Gráficas,2004.2704060872397,2,6,4
3,5ª Completo Fundamental,3714,Recreadores,1685.4077090570859,-65,183,248
3,5ª Completo Fundamental,3721,Captadores De Imagens Em Movimento,1635.0058619181314,0,11,11
3,5ª Completo Fundamental,3722,Operadores De Rede De Teleprocessamento E Afins,1849.1445454684172,-13,5,18
3,5ª Completo Fundamental,3731,Técnicos De Operação De Registros Sonoro/Audiovisuais,3216.195987059339,-30,18,48
3,5ª Completo Fundamental,3732,Supervisores Operacionais E Técnicos Em Mídias Audiovisuais,3760.0423976353236,-8,3,11
3,5ª Completo Fundamental,3741,Técnicos Em Áudio,1991.259108665335,-28,96,124
3,5ª Completo Fundamental,3742,Técnicos Em Cenografia,2461.3254869249135,-11,25,36
3,5ª Completo Fundamental,3743,Técnicos Em Operação De Aparelhos De Projeção,1398.0875066443334,2,81,79
3,5ª Completo Fundamental,3744,"Técnicos Em Montagem, Edição E Finalização De Mídia Audiovisual",3579.7482412970176,-41,124,165
3,5ª Completo Fundamental,3751,"Designers De Interiores, De Vitrines E Visual Merchandiser E Afins (Nível Médio)",10216.713796963533,-14,28,42
3,5ª Completo Fundamental,3761,Dançarinos Tradicionais E Populares,2100,0,1,1
3,5ª Completo Fundamental,3762,Artistas De Circo (Circenses),1320.0045089546827,-12,26,38
3,5ª Completo Fundamental,3763,"Apresentadores De Eventos, Programas E Espetáculos",1200.1518751972853,-4,8,12
3,5ª Completo Fundamental,3771,Atletas Profissionais,2323.5290624889794,13,94,81
3,5ª Completo Fundamental,3772,Árbitros Desportivos,1361.4999752044678,-3,0,3
3,5ª Completo Fundamental,3911,"Planejadores, Programadores E Controladores De Produção E Manutenção",2349.42436612798,-133,901,1034
3,5ª Completo Fundamental,3912,Técnicos De Controle Da Produção,2040.3974731412761,-375,627,1002
3,5ª Completo Fundamental,3951,Técnicos De Apoio Em Pesquisa E Desenvolvimento,1921.3021733036749,-22,48,70
3,5ª Completo Fundamental,4101,Supervisores Administrativos,3127.9072074347023,-867,1110,1977
3,5ª Completo Fundamental,4102,"Supervisores De Serviços Financeiros, De Câmbio E De Controle",3974.277521220811,-164,163,327
3,5ª Completo Fundamental,4110,"Agentes, Assistentes E Auxiliares Administrativos",1651.3763297537444,-1729,9036,10765
3,5ª Completo Fundamental,4121,Operadores De Equipamentos De Entrada E Transmissão De Dados,1478.3051511477802,-20,44,64
3,5ª Completo Fundamental,4122,Contínuos,1437.5758908320604,-614,2331,2945
3,5ª Completo Fundamental,4131,Auxiliares De Contabilidade,1911.683836276378,-46,270,316
3,5ª Completo Fundamental,4132,Escriturários De Serviços Bancários,1648.5892747144994,-17,200,217
3,5ª Completo Fundamental,4141,Almoxarifes E Armazenistas,1700.8520419038537,-762,15204,15966
3,5ª Completo Fundamental,4142,Apontadores E Conferentes,2360.10311030274,-1091,2770,3861
3,5ª Completo Fundamental,4151,"Auxiliares De Serviços De Documentação, Informação E Pesquisa",2066.317785584912,-21,83,104
3,5ª Completo Fundamental,4152,"Trabalhadores Nos Serviços De Classificação E Entregas De Correspondências, Encomendas E Publicações",3183.152698168599,-51,272,323
3,5ª Completo Fundamental,4201,Supervisores De Atendimento Ao Público E De Pesquisa,2084.974485891699,-92,57,149
3,5ª Completo Fundamental,4211,Caixas E Bilheteiros (Exceto Caixa De Banco),1430.0630220983296,-1068,3691,4759
3,5ª Completo Fundamental,4212,Coletadores De Apostas E De Jogos,1312.820378197564,-24,62,86
3,5ª Completo Fundamental,4213,Cobradores E Afins,1438.0507210905473,-128,208,336
3,5ª Completo Fundamental,4221,Recepcionistas,1542.782444230249,-490,2249,2739
3,5ª Completo Fundamental,4222,Operadores De Telefonia,1596.5579892494227,-55,67,122
3,5ª Completo Fundamental,4223,Operadores De Telemarketing E Afins,1374.0334722536713,-86,474,560
3,5ª Completo Fundamental,4231,Despachantes Documentalistas E Afins,2035.8619819675387,-17,129,146
3,5ª Completo Fundamental,4241,Entrevistadores E Recenseadores,1202.75150738797,-2,49,51
3,5ª Completo Fundamental,4242,Aplicadores De Provas E Afins,2000,0,3,3
3,5ª Completo Fundamental,5101,"Supervisores Dos Serviços De Transporte, Turismo, Hotelaria E Administração De Edifícios",3773.570072284067,-163,188,351
3,5ª Completo Fundamental,5102,Supervisores De Lavanderia,1680.444084685983,-41,31,72
3,5ª Completo Fundamental,5103,"Supervisores Dos Serviços De Proteção, Segurança E Outros",2530.2419977322434,-84,35,119
3,5ª Completo Fundamental,5111,Trabalhadores De Segurança E Atendimento Aos Usuários Nos Transportes,1509.6213612674885,-15,11,26
3,5ª Completo Fundamental,5112,Fiscais E Cobradores Dos Transportes Coletivos,1694.851573142419,-2131,518,2649
3,5ª Completo Fundamental,5114,Guias De Turismo,1696.1599943741508,2,24,22
3,5ª Completo Fundamental,5115,Condutores De Turismo,1475.2482394748263,4,9,5
3,5ª Completo Fundamental,5121,Trabalhadores Dos Serviços Domésticos Em Geral,1392.6883799735492,88,1445,1357
3,5ª Completo Fundamental,5131,Mordomos E Governantas,1453.5988660071318,-11,186,197
3,5ª Completo Fundamental,5132,Cozinheiros,9084.497223726114,-3871,18514,22385
3,5ª Completo Fundamental,5133,"Camareiros, Roupeiros E Afins",1403.5943350398934,-700,3862,4562
3,5ª Completo Fundamental,5134,"Trabalhadores No Atendimento Em Estabelecimentos De Serviços De Alimentação, Bebidas E Hotelaria",1514.3024625159387,-3534,13438,16972
3,5ª Completo Fundamental,5135,Trabalhadores Auxiliares Nos Serviços De Alimentação,1469.7928855514708,-256,18151,18407
3,5ª Completo Fundamental,5136,"Churrasqueiros, Pizzaiolos E Sushimen",2514.440979223659,-165,1148,1313
3,5ª Completo Fundamental,5141,Trabalhadores Nos Serviços De Administração De Edifícios,1607.7995424157846,-2109,9266,11375
3,5ª Completo Fundamental,5142,"Trabalhadores Nos Serviços De Coleta De Resíduos, De Limpeza E Conservação De Áreas Públicas",1940.7518814152343,-3298,24158,27456
3,5ª Completo Fundamental,5143,Trabalhadores Nos  Serviços De Manutenção De Edificações,1753.0181591730586,-4876,116027,120903
3,5ª Completo Fundamental,5151,Trabalhadores Em Serviços De Promoção E Apoio À Saúde,1440.0388121430842,-54,412,466
3,5ª Completo Fundamental,5152,Auxiliares De Laboratório Da Saúde,1489.1166875682825,-99,214,313
3,5ª Completo Fundamental,5153,"Trabalhadores De Atenção, Defesa E Proteção A Pessoas Em Situação De Risco E Adolescentes Em Conflito Com A Lei",2045.8010648768104,-29,207,236
3,5ª Completo Fundamental,5161,Trabalhadores Nos Serviços De Embelezamento E Higiene,1368.9138619856028,-193,105,298
3,5ª Completo Fundamental,5162,"Cuidadores De Crianças, Jovens, Adultos E Idosos",3047.772443365928,-70,1035,1105
3,5ª Completo Fundamental,5163,"Tintureiros, Lavadeiros E Afins, A Máquina",1531.5715036265165,-579,2653,3232
3,5ª Completo Fundamental,5164,"Lavadores E Passadores De Roupa, A Mão",1431.075382077094,-91,214,305
3,5ª Completo Fundamental,5165,Trabalhadores Dos Serviços Funerários,2105.3471845899307,-10,219,229
3,5ª Completo Fundamental,5166,Trabalhadores Auxiliares Dos Serviços Funerários,2141.981230519984,1,282,281
3,5ª Completo Fundamental,5171,"Bombeiros, Salva-Vidas E Afins",1751.3518636851034,-30,279,309
3,5ª Completo Fundamental,5172,"Policiais, Guardas-Civis Municipais E Agentes De Trânsito",1691.8616454985647,-26,188,214
3,5ª Completo Fundamental,5173,Vigilantes E Guardas De Segurança,1722.8842229891409,-2553,5349,7902
3,5ª Completo Fundamental,5174,"Porteiros, Vigias E Afins",1699.869452501,-6323,18527,24850
3,5ª Completo Fundamental,5191,Motociclistas E Ciclistas De Entregas Rápidas,1837.380502398816,-25,1830,1855
3,5ª Completo Fundamental,5192,Trabalhadores Da Coleta E Seleção De Material Reciclável,1702.2732752078512,-46,1127,1173
3,5ª Completo Fundamental,5193,"Trabalhadores De Serviços Veterinários, De Higiene E Estética De Animais Domésticos",1386.293126927836,0,281,281
3,5ª Completo Fundamental,5199,Outros Trabalhadores Dos Serviços,2009.023496383331,-457,3815,4272
3,5ª Completo Fundamental,5201,Supervisores De Vendas E De Prestação De Serviços,2313.5380643730887,-281,149,430
3,5ª Completo Fundamental,5211,Operadores Do Comércio Em Lojas E Mercados,1631.4415720399386,-5960,31620,37580
3,5ª Completo Fundamental,5231,Instaladores De Produtos E Acessórios,1682.8098363211438,-38,249,287
3,5ª Completo Fundamental,5241,Vendedores Em Domicílio,1304.2106304386932,-33,421,454
3,5ª Completo Fundamental,5242,"Vendedores Em Bancas, Quiosques E Barracas",1321.8963781534583,-31,48,79
3,5ª Completo Fundamental,5243,Vendedores Ambulantes,1209.1374551912634,-9,99,108
3,5ª Completo Fundamental,6110,Produtores Agropecuários Em Geral,1281.6315626366927,-2,338,340
3,5ª Completo Fundamental,6120,Produtores Agrícolas Polivalentes,1453.863209432296,11,314,303
3,5ª Completo Fundamental,6121,Produtores Agrícolas Na Cultura De Gramíneas,1524.1576486864276,-6,66,72
3,5ª Completo Fundamental,6123,Produtores Agrícolas Na Olericultura,1328.8684626788731,-5,28,33
3,5ª Completo Fundamental,6124,Produtores Agrícolas No Cultivo De Flores E Plantas Ornamentais,1462.4017781575521,-2,14,16
3,5ª Completo Fundamental,6125,Produtores Agrícolas Na Fruticultura,1221.9131453542998,0,99,99
3,5ª Completo Fundamental,6126,Produtores Agrícolas Na Cultura De Plantas Estimulantes,1325.1785714285716,1,5,4
3,5ª Completo Fundamental,6127,Produtores Agrícolas Na Cultura De Plantas Oleaginosas,1423.160009765625,-1,2,3
3,5ª Completo Fundamental,6128,Produtores De Especiarias E De Plantas Aromáticas E Medicinais,1314.760009765625,2,2,0
3,5ª Completo Fundamental,6130,Produtores Em Pecuária Polivalente,1391.3964910199566,-10,30,40
3,5ª Completo Fundamental,6131,Produtores Em Pecuária De Animais De Grande Porte,1397.2323110065763,-19,126,145
3,5ª Completo Fundamental,6132,Produtores Em Pecuária De Animais De Médio Porte,1448.0834200209465,11,69,58
3,5ª Completo Fundamental,6133,Produtores Da Avicultura E Cunicultura,3444.7657399866102,71,406,335
3,5ª Completo Fundamental,6134,Produtores De Animais E Insetos Úteis,1318.832910285425,-8,8,16
3,5ª Completo Fundamental,6201,Supervisores Na Exploração Agropecuária,3520.904893834367,-655,2791,3446
3,5ª Completo Fundamental,6210,Trabalhadores Agropecuários Em Geral,1764.5812705395158,-3544,72391,75935
3,5ª Completo Fundamental,6220,Trabalhadores De Apoio À Agricultura,2146.821376456147,-487,64372,64859
3,5ª Completo Fundamental,6221,Trabalhadores Agrícolas Na Cultura De Gramíneas,1680.433299776545,4010,79764,75754
3,5ª Completo Fundamental,6222,Trabalhadores Agrícolas Na Cultura De Plantas Fibrosas,1485.3089744206063,-4,205,209
3,5ª Completo Fundamental,6223,Trabalhadores Agrícolas Na Olericultura,1264.9190937805108,279,6836,6557
3,5ª Completo Fundamental,6224,Trabalhadores Agrícolas No Cultivo De Flores E Plantas Ornamentais,1380.6546527537998,-462,1490,1952
3,5ª Completo Fundamental,6225,Trabalhadores Agrícolas Na Fruticultura,1708.5844489522076,3143,84146,81003
3,5ª Completo Fundamental,6226,Trabalhadores Agrícolas Nas Culturas De Plantas Estimulantes,1470.435832010953,130,19236,19106
3,5ª Completo Fundamental,6227,Trabalhadores Agrícolas Na Cultura De Plantas Oleaginosas,1657.7464243364536,105,2335,2230
3,5ª Completo Fundamental,6228,Trabalhadores Agrícolas Da Cultura De Especiarias E De Plantas Aromáticas E Medicinais,1243.4546490595499,-1,87,88
3,5ª Completo Fundamental,6230,Tratadores Polivalentes De Animais,1959.3484024581865,-327,4303,4630
3,5ª Completo Fundamental,6231,Trabalhadores Na Pecuária De Animais De Grande Porte,1863.1122715209062,-1500,16655,18155
3,5ª Completo Fundamental,6232,Trabalhadores Na Pecuária De Animais De Médio Porte,1601.4531427178165,-149,2060,2209
3,5ª Completo Fundamental,6233,Trabalhadores Na Avicultura E Cunicultura,1381.7554115038395,-422,6690,7112
3,5ª Completo Fundamental,6234,Trabalhadores Na Criação De Insetos E Animais Úteis,1422.613593565453,-8,51,59
3,5ª Completo Fundamental,6301,Supervisores Na Área Florestal E Aqüicultura,2246.366177300332,-74,188,262
3,5ª Completo Fundamental,6310,Pescadores Polivalentes,1384.0539678317398,1,35,34
3,5ª Completo Fundamental,6311,Pescadores Profissionais Artesanais De Água Doce,466.7496487801535,5,31,26
3,5ª Completo Fundamental,6312,Pescadores De Água Costeira E Alto Mar,5931.289901727501,-11,1382,1393
3,5ª Completo Fundamental,6313,Criadores De Animais Aquáticos,2762.4885484348138,30,478,448
3,5ª Completo Fundamental,6314,Trabalhadores De Apoio À Pesca,1747.281721335191,-1,59,60
3,5ª Completo Fundamental,6320,Trabalhadores Florestais Polivalentes,2261.054731266673,9,214,205
3,5ª Completo Fundamental,6321,Extrativistas E Reflorestadores De Espécies Produtoras De Madeira,1454.7743181847745,-127,12413,12540
3,5ª Completo Fundamental,6322,Extrativistas Florestais De Espécies Produtoras De Gomas E Resinas,997.9081783189741,636,6191,5555
3,5ª Completo Fundamental,6323,"Extrativistas Florestais De Espécies Produtoras De Fibras, Ceras E Óleos",2229.3033081662097,30,594,564
3,5ª Completo Fundamental,6324,Extrativistas Florestais De Espécies Produtoras De Alimentos Silvestres,1187.3301288794796,-21,146,167
3,5ª Completo Fundamental,6325,"Extrativistas Florestais De Espécies Produtoras De Substâncias Aromáticas, Medicinais E Tóxicas",1437.8625785602294,-7,111,118
3,5ª Completo Fundamental,6326,Carvoejadores,313457.0442074517,-80,2150,2230
3,5ª Completo Fundamental,6410,Trabalhadores Da Mecanização Agrícola,4566.347666132985,-985,29779,30764
3,5ª Completo Fundamental,6420,Trabalhadores Da Mecanização Florestal,1905.426981788168,-140,1647,1787
3,5ª Completo Fundamental,6430,Trabalhadores Da Irrigação E Drenagem,1522.4918610682703,-78,593,671
3,5ª Completo Fundamental,7101,Supervisores Da Extração Mineral,4057.0793380301343,-79,88,167
3,5ª Completo Fundamental,7102,Supervisores Da Construção Civil,3158.588252287608,-960,6895,7855
3,5ª Completo Fundamental,7111,Trabalhadores Da Extração De Minerais Sólidos,1813.2112834557956,-137,1040,1177
3,5ª Completo Fundamental,7112,Trabalhadores De Extração De Minerais Sólidos (Operadores De Máquinas),4742.58003548045,-112,2647,2759
3,5ª Completo Fundamental,7113,Trabalhadores Da Extração De Minerais Líquidos E Gasosos,2257.0643892403655,-30,406,436
3,5ª Completo Fundamental,7114,Garimpeiros E Operadores De Salinas,1310.8811586417405,0,58,58
3,5ª Completo Fundamental,7121,Trabalhadores De Beneficiamento De Minérios,1969.3213110416505,-42,441,483
3,5ª Completo Fundamental,7122,Trabalhadores De Beneficiamento De Pedras Ornamentais,1720.816322922683,-199,1092,1291
3,5ª Completo Fundamental,7151,Trabalhadores Na Operação De Máquinas De Terraplenagem E Fundações,2948.032338185353,-496,15014,15510
3,5ª Completo Fundamental,7152,Trabalhadores De Estruturas De Alvenaria,11239.849723715159,121,65370,65249
3,5ª Completo Fundamental,7153,Montadores De Estruturas De Concreto Armado,2399.9721441665,-20,13445,13465
3,5ª Completo Fundamental,7154,Trabalhadores Na Operação De Máquinas De Concreto Usinado E Afins,2187.146349806388,-348,1576,1924
3,5ª Completo Fundamental,7155,"Trabalhadores De Montagem De Estruturas De Madeira, Metal E Compósitos Em Obras Civis",2339.775217932938,151,28409,28258
3,5ª Completo Fundamental,7156,Trabalhadores De Instalações Elétricas,2912.960806434952,-151,4420,4571
3,5ª Completo Fundamental,7157,Aplicadores De Materiais Isolantes,2324.372389907084,-44,982,1026
3,5ª Completo Fundamental,7161,Revestidores De Concreto,1835.2680798096667,-17,199,216
3,5ª Completo Fundamental,7162,Telhadores (Revestimentos Rígidos),1964.658515376338,5,77,72
3,5ª Completo Fundamental,7163,Vidraceiros (Revestimentos Rígidos),1699.9850117356684,-44,508,552
3,5ª Completo Fundamental,7164,Gesseiros,2436.2671226424955,-50,2766,2816
3,5ª Completo Fundamental,7165,"Aplicadores De Revestimentos Cerâmicos, Pastilhas, Pedras E Madeiras",2462.984194165927,-51,2023,2074
3,5ª Completo Fundamental,7166,Pintores De Obras E Revestidores De Interiores (Revestimentos Flexíveis),2180.8255593723816,-18,7738,7756
3,5ª Completo Fundamental,7170,Ajudantes De Obras Civis,2141.119004425291,9566,128496,118930
3,5ª Completo Fundamental,7201,"Supervisores De Usinagem, Conformação E Tratamento De Metais",5164.837496485131,-77,261,338
3,5ª Completo Fundamental,7202,Supervisores Da Fabricação E Montagem Metalmecânica,4293.771712392236,-46,30,76
3,5ª Completo Fundamental,7211,Ferramenteiros E Afins,2086.60030941566,-62,196,258
3,5ª Completo Fundamental,7212,Preparadores E Operadores De Máquinas-Ferramenta Convencionais,10323.769373852268,-661,1504,2165
3,5ª Completo Fundamental,7213,Afiadores E Polidores De Metais,2301.5915756277946,-110,665,775
3,5ª Completo Fundamental,7214,Operadores De Máquinas De Usinagem Cnc,2843.3356530128694,-68,235,303
3,5ª Completo Fundamental,7221,Trabalhadores De Forjamento De Metais,2262.627886749507,-57,456,513
3,5ª Completo Fundamental,7222,Trabalhadores De Fundição De Metais Puros E De Ligas Metálicas,5308.1107860126085,-37,1236,1273
3,5ª Completo Fundamental,7223,Trabalhadores De Moldagem De Metais E De Ligas Metálicas,2524.840367705942,-165,551,716
3,5ª Completo Fundamental,7224,Trabalhadores De Trefilação E Estiramento De Metais Puros E Ligas Metálicas,1584.7430708763934,-39,35,74
3,5ª Completo Fundamental,7231,Trabalhadores De Tratamento Térmico De Metais,3690.7435651582505,-34,79,113
3,5ª Completo Fundamental,7232,Trabalhadores De Tratamento De Superfícies De Metais E De Compósitos (Termoquímicos),2080.7850593621283,-66,283,349
3,5ª Completo Fundamental,7233,"Trabalhadores Da Pintura De Equipamentos, Veículos, Estruturas Metálicas E De Compósitos",1971.9867186335784,-304,2447,2751
3,5ª Completo Fundamental,7241,Encanadores E Instaladores De Tubulações,2669.8977244437237,-379,5790,6169
3,5ª Completo Fundamental,7242,Trabalhadores De Traçagem E Montagem De Estruturas Metálicas E De Compósitos,7782.2621478809915,151,8148,7997
3,5ª Completo Fundamental,7243,Trabalhadores De Soldagem E Corte De Ligas Metálicas,3448.067461574398,-495,7431,7926
3,5ª Completo Fundamental,7244,Trabalhadores De Caldeiraria E Serralheria,4279.713427296853,-327,4331,4658
3,5ª Completo Fundamental,7245,Operadores De Máquinas De Conformação De Metais,3200.5586636909416,-263,601,864
3,5ª Completo Fundamental,7246,Trançadores E Laceiros De Cabos De Aço,2525.180112202962,-5,6,11
3,5ª Completo Fundamental,7250,Ajustadores Mecânicos Polivalentes E Afins,2062.4319234680247,-105,666,771
3,5ª Completo Fundamental,7251,"Montadores De Máquinas, Aparelhos E Acessórios Em Linhas De Montagem",2552.0400100868605,-49,504,553
3,5ª Completo Fundamental,7252,Montadores De Máquinas Industriais,2886.4311422239025,16,1788,1772
3,5ª Completo Fundamental,7253,Montadores De Máquinas Pesadas E Equipamentos Agrícolas,2041.3548278154647,-21,113,134
3,5ª Completo Fundamental,7254,Mecânicos Montadores De Motores E Turboalimentadores,1906.1898769943496,-28,99,127
3,5ª Completo Fundamental,7255,Montadores De Veículos Automotores (Linha De Montagem),2383.6496372174834,-89,163,252
3,5ª Completo Fundamental,7257,Instaladores De Equipamentos De Refrigeração E Ventilação,2716.8504712940735,-55,175,230
3,5ª Completo Fundamental,7301,Supervisores De Montagens E Instalações Eletroeletrônicas,4430.417067718506,-12,74,86
3,5ª Completo Fundamental,7311,Montadores De Equipamentos Eletroeletrônicos,2412.0235408186313,-194,3147,3341
3,5ª Completo Fundamental,7312,Montadores De Aparelhos De Telecomunicações,1642.8873197115386,-10,21,31
3,5ª Completo Fundamental,7313,Instaladores-Reparadores De  Linhas E Equipamentos De Telecomunicações,1388.3647167077982,-57,256,313
3,5ª Completo Fundamental,7321,"Instaladores E Reparadores De Linhas E Cabos Elétricos, Telefônicos E De Comunicação De Dados",1823.7567566250225,-415,1792,2207
3,5ª Completo Fundamental,7401,Supervisores Da Mecânica De Precisão E Instrumentos Musicais,3205.1766764322915,-7,1,8
3,5ª Completo Fundamental,7411,Mecânicos De Instrumentos De Precisão,1824.1375206752753,5,78,73
3,5ª Completo Fundamental,7421,Confeccionadores De Instrumentos Musicais,1895.46875,-5,5,10
3,5ª Completo Fundamental,7501,Supervisores De Joalheria E Afins,2011.3683268229167,-2,2,4
3,5ª Completo Fundamental,7502,"Supervisores De Vidraria, Cerâmica E Afins",3269.282485961914,-6,1,7
3,5ª Completo Fundamental,7510,Joalheiros E Lapidadores De Gemas,1384.2165670775705,-5,41,46
3,5ª Completo Fundamental,7511,Artesãos De Metais Preciosos E Semi-Preciosos,1434.8611329320138,-19,74,93
3,5ª Completo Fundamental,7521,"Sopradores, Moldadores E Modeladores De Vidros E Afins",2412.347589737943,-18,17,35
3,5ª Completo Fundamental,7522,Trabalhadores Da Transformação De Vidros Planos,1760.9905076218304,-20,100,120
3,5ª Completo Fundamental,7523,Ceramistas (Preparação E Fabricação),1765.3895837701004,-342,1615,1957
3,5ª Completo Fundamental,7524,Vidreiros E Ceramistas (Arte E Decoração),1648.8634137060822,-44,34,78
3,5ª Completo Fundamental,7601,Supervisores Da Indústria Têxtil,3007.503252590671,-103,209,312
3,5ª Completo Fundamental,7602,Supervisores Na Indústria Do Curtimento,2508.063631924716,-5,3,8
3,5ª Completo Fundamental,7603,Supervisores Na Confecção Do Vestuário,44150.78710256363,-95,91,186
3,5ª Completo Fundamental,7604,Supervisores Na Confecção De Calçados,2772.3610162402606,-57,158,215
3,5ª Completo Fundamental,7605,"Supervisores Da Confecção De Artefatos De Tecidos, Couros E Afins",2225.2864013671874,-5,10,15
3,5ª Completo Fundamental,7606,Supervisores Das Artes Gráficas,3411.244603474935,-12,6,18
3,5ª Completo Fundamental,7610,Trabalhadores Polivalentes Das Indústrias Têxteis,3837.0201154033953,-184,883,1067
3,5ª Completo Fundamental,7611,Trabalhadores Da Classificação De Fibras Têxteis E Lavagem De Lã,1444.3529575892858,-7,19,26
3,5ª Completo Fundamental,7612,Operadores Da Fiação,1499.9069910101082,-106,604,710
3,5ª Completo Fundamental,7613,Operadores De Tear E Máquinas Similares,2496.8209847992503,-351,606,957
3,5ª Completo Fundamental,7614,"Trabalhadores De Acabamento, Tingimento E Estamparia Das Indústrias Têxteis",2741.8555188163737,-123,376,499
3,5ª Completo Fundamental,7618,Inspetores E Revisores De Produção Têxtil,1752.6850352229353,-132,602,734
3,5ª Completo Fundamental,7620,Trabalhadores Polivalentes Do Curtimento De Couros E Peles,1576.3169542997384,67,1218,1151
3,5ª Completo Fundamental,7621,Trabalhadores Da Preparação Do Curtimento De Couros E Peles,1634.4530919612812,-34,80,114
3,5ª Completo Fundamental,7622,Trabalhadores Do Curtimento De Couros E Peles,1733.4553420499867,-45,201,246
3,5ª Completo Fundamental,7623,Trabalhadores Do Acabamento De Couros E Peles,4100.673062429789,-154,320,474
3,5ª Completo Fundamental,7630,Profissionais Polivalentes Da Confecção De Roupas,1708.847311566527,-381,731,1112
3,5ª Completo Fundamental,7631,Trabalhadores Da Preparação Da Confecção De Roupas,1808.7294767550356,-336,2654,2990
3,5ª Completo Fundamental,7632,Operadores De Máquinas Para Costura De Peças Do Vestuário,1789.7762070327572,-2365,7249,9614
3,5ª Completo Fundamental,7633,Operadores De Máquinas Para Bordado E Acabamento De Roupas,1548.4755151930315,-269,886,1155
3,5ª Completo Fundamental,7640,Trabalhadores Polivalentes Da Confecção De Calçados,1472.6320728414269,-266,3937,4203
3,5ª Completo Fundamental,7641,Trabalhadores Da Preparação Da Confecção De Calçados,1607.8923445720952,153,4102,3949
3,5ª Completo Fundamental,7642,Operadores De Máquinas De Costurar E Montar Calçados,1739.936992920002,-350,1757,2107
3,5ª Completo Fundamental,7643,Trabalhadores De Acabamento De Calçados,1569.130583910837,-105,832,937
3,5ª Completo Fundamental,7650,Trabalhadores Polivalentes Da Confecção De Artefatos De Tecidos E Couros,1369.256633364609,37,107,70
3,5ª Completo Fundamental,7651,"Trabalhadores Da Preparação De Artefatos De Tecidos, Couros E Tapeçaria",1593.2725975186218,-24,145,169
3,5ª Completo Fundamental,7652,"Trabalhadores Da Confecção De Artefatos De Tecidos, Couros E Sintéticos",1760.1547090572678,-123,467,590
3,5ª Completo Fundamental,7653,Operadores De Máquinas Na Confecção De Artefatos De  Couro,1496.0651206402113,12,160,148
3,5ª Completo Fundamental,7654,Trabalhadores Do Acabamento De Artefatos De Tecidos E Couros,1420.7492217523766,13,161,148
3,5ª Completo Fundamental,7661,Trabalhadores Da Pré-Impressão Gráfica,1722.7610119641781,-52,75,127
3,5ª Completo Fundamental,7662,Trabalhadores Da Impressão Gráfica,2481.1935748473793,-230,307,537
3,5ª Completo Fundamental,7663,Trabalhadores Do Acabamento Gráfico,2072.044361141304,-134,383,517
3,5ª Completo Fundamental,7664,Trabalhadores De Laboratório Fotográfico E Radiológico,1423.7976755777995,-7,4,11
3,5ª Completo Fundamental,7681,"Trabalhadores De Tecelagem Manual, Tricô, Crochê, Rendas E Afins",1522.148490878374,-6,46,52
3,5ª Completo Fundamental,7682,Trabalhadores Artesanais Da Confecção De Peças E Tecidos,1431.9769198330964,-20,20,40
3,5ª Completo Fundamental,7683,Trabalhadores Artesanais Da Confecção De Calçados E Artefatos De Couros E Peles,1449.0390374098968,-101,399,500
3,5ª Completo Fundamental,7686,Trabalhadores Tipográficos Linotipistas E Afins,1517.96131574132,-35,69,104
3,5ª Completo Fundamental,7687,Encadernadores E Recuperadores De Livros (Pequenos Lotes Ou A Unidade),1622.1153126592221,-15,7,22
3,5ª Completo Fundamental,7701,"Supervisores Em Indústria De Madeira, Mobiliário E Da Carpintaria Veicular",3684.1194603223803,-129,262,391
3,5ª Completo Fundamental,7711,Marceneiros E Afins,1717.712616028689,-414,2098,2512
3,5ª Completo Fundamental,7721,Trabalhadores De Tratamento E Preparação Da Madeira,1502.850710458925,-237,1303,1540
3,5ª Completo Fundamental,7731,Operadores De Máquinas De Desdobramento Da Madeira,4714.278896881482,-433,2201,2634
3,5ª Completo Fundamental,7732,Operadores De Máquinas De Aglomeração E Prensagem De Chapas,1670.2803541342084,-51,73,124
3,5ª Completo Fundamental,7733,Operadores De Usinagem Convencional De Madeira,2429.094755086054,-352,1323,1675
3,5ª Completo Fundamental,7734,Operadores De Máquina De Usinar Madeira (Produção Em Série),1647.9592428834815,-160,249,409
3,5ª Completo Fundamental,7735,Operadores De Máquinas De Usinagem De Madeira Cnc,1740.8525372099666,-25,58,83
3,5ª Completo Fundamental,7741,Montadores De Móveis E Artefatos De Madeira,1642.5404193030204,-239,1509,1748
3,5ª Completo Fundamental,7751,Trabalhadores De Arte E  Do Acabamento Em Madeira Do Mobiliário,2077.903506736388,-71,164,235
3,5ª Completo Fundamental,7764,"Confeccionadores De Artefatos De Madeira, Móveis De Vime E Afins",1620.6122616494947,-5,57,62
3,5ª Completo Fundamental,7771,Carpinteiros Navais,2648.9270182291666,-3,4,7
3,5ª Completo Fundamental,7772,Carpinteiros De Carrocerias E Carretas,2003.257776896159,-7,25,32
3,5ª Completo Fundamental,7801,Supervisores De Trabalhadores De Embalagem E Etiquetagem,2157.42741084599,-39,52,91
3,5ª Completo Fundamental,7811,Condutores De Processos Robotizados,2331.8352770124166,-5,7,12
3,5ª Completo Fundamental,7813,Operadores De Equipamentos Pilotados Remotamente,1720.9309936523437,6,9,3
3,5ª Completo Fundamental,7817,Trabalhadores Subaquáticos,1583.4029968261718,-2,9,11
3,5ª Completo Fundamental,7821,Operadores De Máquinas E Equipamentos De Elevação,2161.527004245321,-179,2022,2201
3,5ª Completo Fundamental,7822,Operadores De Equipamentos De Movimentação De Cargas,3523.97631447123,-889,2884,3773
3,5ª Completo Fundamental,7823,Motoristas De Veículos De Pequeno E Médio Porte,1969.9379401040537,-1953,8673,10626
3,5ª Completo Fundamental,7824,"Motoristas De Ônibus Urbanos, Metropolitanos E Rodoviários",2477.4263763325853,-5208,9186,14394
3,5ª Completo Fundamental,7825,Motoristas De Veículos De Cargas Em Geral,2371.47834722514,-2933,51920,54853
3,5ª Completo Fundamental,7826,Operadores De Veículos Sobre Trilhos E Cabos Aéreos,1982.280444868784,-9,20,29
3,5ª Completo Fundamental,7827,Trabalhadores Aquaviários,5953.279085924593,-165,329,494
3,5ª Completo Fundamental,7828,Condutores De Animais E De Veículos De Tração Animal E Pedais,1647.0908327010768,-43,97,140
3,5ª Completo Fundamental,7831,Trabalhadores De Manobras De Transportes Sobre Trilhos,2703.708589202619,-31,288,319
3,5ª Completo Fundamental,7832,Trabalhadores De Cargas E Descargas De Mercadorias,4330.717093945564,-611,26539,27150
3,5ª Completo Fundamental,7841,Trabalhadores De Embalagem E De Etiquetagem,1635.286092620448,-891,5948,6839
3,5ª Completo Fundamental,7842,Alimentadores De Linhas De Produção,2060.4180004608165,400,51975,51575
3,5ª Completo Fundamental,7911,Artesãos,5508.737638758846,5,43,38
3,5ª Completo Fundamental,8101,"Supervisores De Produção Em Indústrias Químicas, Petroquímicas E Afins",2660.4161952227014,-37,15,52
3,5ª Completo Fundamental,8102,Supervisores De Produção Em Indústrias De Transformação De Plásticos E Borrachas,3058.50486828032,-32,26,58
3,5ª Completo Fundamental,8103,"Supervisores De Produção Em Indústrias De Produtos Farmacêuticos, Cosméticos E Afins",3919.487939453125,-5,0,5
3,5ª Completo Fundamental,8110,"Operadores Polivalentes De Equipamentos Em Indústrias Químicas, Petroquímicas E Afins",2131.3548164008926,-9,21,30
3,5ª Completo Fundamental,8111,Operadores De Equipamentos De Moagem E Mistura De Materiais (Tratamentos Químicos E Afins),1753.059393690936,-60,212,272
3,5ª Completo Fundamental,8112,Operadores De Calcinação E De Tratamentos Químicos De Materiais Radioativos,1330.173422879951,-30,71,101
3,5ª Completo Fundamental,8113,Operadores De Equipamentos De Filtragem E Separação,1740.5935167786351,-48,101,149
3,5ª Completo Fundamental,8114,"Operadores De Equipamentos De Destilação, Evaporação E Reação",6226.233136603953,-66,146,212
3,5ª Completo Fundamental,8115,Operadores De Equipamentos De Produção E Refino De Petróleo E Gás,3777.3532511393228,-1,3,4
3,5ª Completo Fundamental,8116,Operadores De Equipamentos De Coqueificação,1803.7512658714352,-25,55,80
3,5ª Completo Fundamental,8117,"Operadores De Instalações E Máquinas De Produtos Plásticos, De Borracha E Moldadores De Parafinas",2020.6932148291755,-323,2068,2391
3,5ª Completo Fundamental,8118,"Operadores De Máquinas E Instalações De Produtos Farmacêuticos, Cosméticos E Afins",1666.970790623544,-58,98,156
3,5ª Completo Fundamental,8121,Trabalhadores Da Fabricação De Munição E Explosivos Químicos,1290.3750235325265,-83,190,273
3,5ª Completo Fundamental,8131,"Operadores De Processos Das Indústrias De Transformação De Produtos Químicos, Petroquímicos E Afins",2288.5901823916793,-197,612,809
3,5ª Completo Fundamental,8181,Laboratoristas Industriais Auxiliares,1625.5858336234387,-63,159,222
3,5ª Completo Fundamental,8201,Supervisores De Produção Em Indústrias Siderúrgicas,2795.402510070801,-16,11,27
3,5ª Completo Fundamental,8202,Supervisores Na Fabricação De Materiais Para Construção (Vidros E Cerâmicas),2887.294668227517,-35,67,102
3,5ª Completo Fundamental,8211,Operadores De Instalações De Sinterização,1607.9968651753784,-16,33,49
3,5ª Completo Fundamental,8212,Operadores De Fornos De Primeira  Fusão E Aciaria,13919.914424391312,-76,1497,1573
3,5ª Completo Fundamental,8213,Operadores De Equipamentos De Laminação,2056.516769527302,-61,163,224
3,5ª Completo Fundamental,8214,Operadores De Equipamentos De Acabamento De Chapas E Metais,2097.85061187227,-170,1753,1923
3,5ª Completo Fundamental,8221,Forneiros Metalúrgicos (Segunda Fusão E Reaquecimento),11226.812742463406,-45,140,185
3,5ª Completo Fundamental,8231,"Operadores Na Preparação De Massas Para Abrasivo, Vidro, Cerâmica, Porcelana E Materiais De Construção",1768.4496412092576,-13,76,89
3,5ª Completo Fundamental,8232,"Operadores De Equipamentos De Fabricação  E Beneficiamento De Cristais, Vidros, Cerâmicas, Porcelanas, Fibras De Vidro, Abrasivos E Afins",2175.209155263773,-57,136,193
3,5ª Completo Fundamental,8233,Operadores De Instalações E Equipamentos De Fabricação De Materiais De Construção,1658.1396003844425,-91,2183,2274
3,5ª Completo Fundamental,8281,Trabalhadores Da Fabricação De Cerâmica Estrutural Para Construção,2006.7100855333626,-653,3214,3867
3,5ª Completo Fundamental,8301,Supervisores Da Fabricação De Celulose E Papel,2782.8291042751734,-21,12,33
3,5ª Completo Fundamental,8311,Preparadores De Pasta Para Fabricação De Papel,6686.682623057478,-37,63,100
3,5ª Completo Fundamental,8321,Operadores De Máquinas De Fabricar Papel E Papelão,3546.03891860496,-146,161,307
3,5ª Completo Fundamental,8331,Operadores De Máquinas Na Fabricação De Produtos De Papel E Papelão,1657.122066778078,-78,274,352
3,5ª Completo Fundamental,8332,Trabalhadores Artesanais De Produtos De Papel E Papelão,1413.6917535691034,2,127,125
3,5ª Completo Fundamental,8401,"Supervisores Da Fabricação De Alimentos, Bebidas E Fumo",3578.49594483262,-146,134,280
3,5ª Completo Fundamental,8411,"Trabalhadores Da Indústria De Beneficiamento De Grãos, Cereais E Afins",2240.3542324163477,-114,535,649
3,5ª Completo Fundamental,8412,Trabalhadores No Beneficiamento Do Sal,872.2281817560611,-17,83,100
3,5ª Completo Fundamental,8413,Trabalhadores Na Fabricação E Refino De Açúcar,3478.60906348543,-9,861,870
3,5ª Completo Fundamental,8414,Trabalhadores Na Fabricação E Conservação De Alimentos,1531.0887746537758,-596,2973,3569
3,5ª Completo Fundamental,8415,Trabalhadores Na Pasteurização Do Leite E Na Fabricação De Laticínios  E Afins,1442.322160907463,-178,749,927
3,5ª Completo Fundamental,8416,"Trabalhadores Na Industrialização De Café, Cacau, Mate E De Produtos Afins",1586.5441426920688,-28,82,110
3,5ª Completo Fundamental,8417,"Trabalhadores Na Fabricação De Cachaça, Cerveja, Vinhos E Outras Bebidas",2415.7287189348745,-41,293,334
3,5ª Completo Fundamental,8418,"Operadores De Equipamentos Na Fabricação De Pães, Massas Alimentícias, Doces, Chocolates E Achocolatados",1912.2246028677982,-304,394,698
3,5ª Completo Fundamental,8421,Cigarreiros E Beneficiadores De Fumo,1516.926595834472,223,4215,3992
3,5ª Completo Fundamental,8422,Charuteiros,1563.5112533569336,-2,7,9
3,5ª Completo Fundamental,8481,Trabalhadores Artesanais Na Conservação De Alimentos,1673.972174835253,-56,315,371
3,5ª Completo Fundamental,8482,Trabalhadores Artesanais Na Pasteurização Do Leite E Na Fabricação De Laticínios E Afins,1722.9332781416642,-103,166,269
3,5ª Completo Fundamental,8483,"Padeiros, Confeiteiros E Afins",2478.326826202601,-1164,3407,4571
3,5ª Completo Fundamental,8484,Trabalhadores Na Degustação E Classificação De Grãos E Afins,1597.0093041615894,-57,186,243
3,5ª Completo Fundamental,8485,Magarefes E Afins,1609.8518356638124,-2761,15751,18512
3,5ª Completo Fundamental,8486,Trabalhadores Artesanais Na Indústria Do Fumo,1410.2445856900824,72,1079,1007
3,5ª Completo Fundamental,8601,Supervisores Da Produção De Utilidades,3220.2135690282666,-76,81,157
3,5ª Completo Fundamental,8611,"Operadores De Instalações De Geração E Distribuição De Energia Elétrica, Hidráulica, Térmica Ou Nuclear",2421.7442070072534,-36,38,74
3,5ª Completo Fundamental,8612,Operadores De Instalações De Distribuição De Energia Elétrica,2230.1542524857955,-9,12,21
3,5ª Completo Fundamental,8621,Operadores De Máquinas A Vapor E Utilidades,6318.6382758063655,-1695,4010,5705
3,5ª Completo Fundamental,8622,"Operadores De Instalações De Captação, Tratamento E Distribuição De Água",3215.094132739904,-58,201,259
3,5ª Completo Fundamental,8623,Operadores De Instalações De Captação E Esgotos,1777.2637210064786,-176,399,575
3,5ª Completo Fundamental,8624,"Operadores De Instalações De Extração, Processamento, Envasamento E Distribuição De Gases",1762.2462224187077,-9,14,23
3,5ª Completo Fundamental,8625,Operadores De Instalações De Refrigeração E Ar-Condicionado,10041.524236681447,-14,80,94
3,5ª Completo Fundamental,9101,"Supervisores Em Serviços De Reparação E Manutenção De Máquinas E Equipamentos Industriais, Comerciais E Residenciais",3259.1725786164516,-129,317,446
3,5ª Completo Fundamental,9102,Supervisores Em Serviços De Reparação E Manutenção Veicular,3436.151458829233,-57,62,119
3,5ª Completo Fundamental,9109,"Supervisores De Outros Trabalhadores De Serviços De Reparação, Conservação E Manutenção",3421.7253835967094,5,33,28
3,5ª Completo Fundamental,9111,"Mecânicos De Manutenção De Bombas, Motores, Compressores E Equipamentos De Transmissão",2201.340134644869,-102,474,576
3,5ª Completo Fundamental,9112,Mecânicos De Manutenção E Instalação De Aparelhos De  Climatização E Refrigeração,1612.4088834140302,-1,470,471
3,5ª Completo Fundamental,9113,Mecânicos De Manutenção De Máquinas Industriais,3827.5099616880098,-795,3411,4206
3,5ª Completo Fundamental,9131,Mecânicos De Manutenção De Máquinas Pesadas E Equipamentos Agrícolas,2938.3112473004294,-174,1377,1551
3,5ª Completo Fundamental,9141,Mecânicos De Manutenção Aeronáutica,1941.5178109152275,-16,41,57
3,5ª Completo Fundamental,9142,Mecânicos De Manutenção De Motores E Equipamentos Navais,2559.3828560965403,0,7,7
3,5ª Completo Fundamental,9143,Mecânicos De Manutenção Metroferroviária,1783.1834826506386,-21,54,75
3,5ª Completo Fundamental,9144,Mecânicos De Manutenção De Veículos Automotores,2318.257186131024,-833,5445,6278
3,5ª Completo Fundamental,9151,Técnicos Em Manutenção E Reparação De Instrumentos De Medição E Precisão,2763.5192868492823,0,30,30
3,5ª Completo Fundamental,9153,Técnicos Em Manutenção E Reparação De Equipamentos Biomédicos,2277.728342692057,2,7,5
3,5ª Completo Fundamental,9191,Lubrificadores,2089.953808826053,-172,875,1047
3,5ª Completo Fundamental,9192,"Trabalhadores De Manutenção De Roçadeiras, Motoserras E Similares",1850.708617428787,-103,407,510
3,5ª Completo Fundamental,9193,Mecânicos De Manutenção De Bicicletas E Equipamentos Esportivos E De Ginástica,2987.079063849791,0,146,146
3,5ª Completo Fundamental,9501,"Supervisores De Manutenção Eletroeletrônica Industrial, Comercial E Predial",3573.456399054553,-103,193,296
3,5ª Completo Fundamental,9502,Supervisores De Manutenção Eletroeletrônica Veicular,2446.617989095052,-12,9,21
3,5ª Completo Fundamental,9503,Supervisores De Manutenção Eletromecânica,6696.194372344436,-1,28,29
3,5ª Completo Fundamental,9511,Eletricistas De Manutenção Eletroeletrônica,3523.570705758396,-204,1374,1578
3,5ª Completo Fundamental,9513,Instaladores E Mantenedores De Sistemas Eletroeletrônicos De Segurança,1505.4788644903028,-92,223,315
3,5ª Completo Fundamental,9531,"Eletricistas Eletrônicos De Manutenção Veicular (Aérea, Terrestre E Naval)",1971.8944474062912,-127,527,654
3,5ª Completo Fundamental,9541,"Instaladores E Mantenedores Eletromecânicos De Elevadores, Escadas E Portas Automáticas",3971.1297856817437,-33,261,294
3,5ª Completo Fundamental,9542,Reparadores De Aparelhos Eletrodomésticos,29357.06368582589,-13,7,20
3,5ª Completo Fundamental,9543,Reparadores De Equipamentos De Escritório,1950.659090909091,-3,4,7
3,5ª Completo Fundamental,9911,Conservadores De Vias Permanentes (Trilhos),2346.305996692775,62,776,714
3,5ª Completo Fundamental,9912,Mantenedores De Equipamentos De Parques De Diversões E Similares,1361.953821518842,-10,29,39
3,5ª Completo Fundamental,9913,Reparadores De Carrocerias De Veículos,2460.434805500303,-202,1046,1248
3,5ª Completo Fundamental,9921,Trabalhadores Elementares De Serviços De Manutenção Veicular,2681.1980404215806,-310,1912,2222
3,5ª Completo Fundamental,9922,Trabalhadores Operacionais De Conservação De Vias Permanentes (Exceto Trilhos),1841.578459698397,-531,9425,9956
4,6ª a 9ª Fundamental,0000,Não especificado,2228.634884947368,232,393,161
4,6ª a 9ª Fundamental,0101,Oficiais Generais Das Forças Armadas,1541.9774908356085,6,65,59
4,6ª a 9ª Fundamental,0102,Oficiais Das Forças Armadas,2029.5630708240326,3,12,9
4,6ª a 9ª Fundamental,0103,Praças Das Forças Armadas,1463.3405918666294,7,31,24
4,6ª a 9ª Fundamental,0201,Oficiais Superiores Da Polícia Militar,1422,0,1,1
4,6ª a 9ª Fundamental,0211,Subtenentes E Sargentos Da Policia Militar,1100,-2,0,2
4,6ª a 9ª Fundamental,0301,Oficiais Superiores Do Corpo De Bombeiros Militar,1698.155029296875,-1,1,2
4,6ª a 9ª Fundamental,0303,Tenentes Do Corpo De Bombeiros Militar,1481.07666015625,-1,1,2
4,6ª a 9ª Fundamental,0312,Cabos E Soldados Do Corpo De Bombeiros Militar,1736.25,1,2,1
4,6ª a 9ª Fundamental,1111,Legisladores,1520.4597057766384,3,19,16
4,6ª a 9ª Fundamental,1112,Dirigentes Gerais Da Administração Pública,8765.393518518518,0,14,14
4,6ª a 9ª Fundamental,1113,Magistrados,1620.4249877929688,-1,1,2
4,6ª a 9ª Fundamental,1114,Dirigentes Do Serviço Público,4216.261465363143,33,103,70
4,6ª a 9ª Fundamental,1115,Gestores Públicos,3200,1,2,1
4,6ª a 9ª Fundamental,1141,Dirigentes De Partidos Políticos,2688.77001953125,0,1,1
4,6ª a 9ª Fundamental,1142,Dirigentes E Administradores De Entidades Patronais E Dos Trabalhadores E De Outros Interesses Sócioeconômicos,2688.164623260498,-5,4,9
4,6ª a 9ª Fundamental,1143,Dirigentes E Administradores De Entidades Religiosas,1320,1,1,0
4,6ª a 9ª Fundamental,1144,Dirigentes E Administradores De Organizações Da Sociedade Civil Sem Fins Lucrativos,1860,3,6,3
4,6ª a 9ª Fundamental,1210,Diretores Gerais,1647.0816350253122,-20,210,230
4,6ª a 9ª Fundamental,1221,"Diretores De Produção E Operações Em Empresa Agropecuária, Pesqueira , Aqüícola E Florestal",1811.8472638811384,-3,7,10
4,6ª a 9ª Fundamental,1222,"Diretores De Produção E Operações Em Empresa Da Indústria Extrativa, Transformação E De Serviços De Utilidade Pública",2629.7562561035156,6,15,9
4,6ª a 9ª Fundamental,1223,Diretores De Operações De Obras Em Empresa De Construção,1374.6409245338762,15,67,52
4,6ª a 9ª Fundamental,1224,Diretores De Operações Em Empresa Do Comércio,4071.0635724748886,2,8,6
4,6ª a 9ª Fundamental,1225,"Diretores De Serviços De Turismo, De Alojamento E De Alimentação",2555.094723171658,11,13,2
4,6ª a 9ª Fundamental,1226,"Diretores De Operações De Serviços Em Empresa De Armazenamento, De Transporte E De Telecomunicação",1785.8748577541774,-3,8,11
4,6ª a 9ª Fundamental,1227,Diretores De Operações De Serviços Em Instituição De Intermediação Financeira,2104,-1,0,1
4,6ª a 9ª Fundamental,1231,Diretores Administrativos E Financeiros,2525.9872784879894,-66,150,216
4,6ª a 9ª Fundamental,1232,Diretores De Recursos Humanos E Relações De Trabalho,13537.149592081705,-1,3,4
4,6ª a 9ª Fundamental,1233,Diretores De Comercialização E Marketing,2567.0222697197637,-10,41,51
4,6ª a 9ª Fundamental,1234,Diretores De Suprimentos E Afins,13025.75,1,3,2
4,6ª a 9ª Fundamental,1236,Diretores De Tecnologia Da Informação,2315.70390625,-5,0,5
4,6ª a 9ª Fundamental,1237,Diretores De Pesquisa E Desenvolvimento,1512.5366617838542,-1,1,2
4,6ª a 9ª Fundamental,1238,Diretores De Manutenção,2535.3968999953495,-2,20,22
4,6ª a 9ª Fundamental,1311,"Diretores E Gerentes De Operações Em Empresa De Serviços Pessoais, Sociais E Culturais",2081.23993414753,-17,53,70
4,6ª a 9ª Fundamental,1312,"Gestores E Especialistas De Operações Em Empresas, Secretarias E Unidades De Serviços De Saúde",1992.2110299645574,-12,36,48
4,6ª a 9ª Fundamental,1313,Diretores E Gerentes De Instituição De Serviços Educacionais,7854.640984548229,-6,17,23
4,6ª a 9ª Fundamental,1411,"Gerentes De Produção E Operações Em Empresa Agropecuária, Pesqueira, Aqüícola E Florestal",2673.582744107279,-122,1115,1237
4,6ª a 9ª Fundamental,1412,"Gerentes De Produção E Operações Em Empresa Da Indústria Extrativa, De Transformação E De Serviços De Utilidade Pública",4180.551054247811,-436,1234,1670
4,6ª a 9ª Fundamental,1413,Gerentes De Obras Em Empresa De Construção,3515.3271260271836,-49,207,256
4,6ª a 9ª Fundamental,1414,Gerentes De Operações Comerciais E De Assistência Técnica,2102.225358799951,-1055,3342,4397
4,6ª a 9ª Fundamental,1415,"Gerentes De Operações De Serviços Em Empresa De Turismo, De Alojamento E Alimentação",2133.9197446343583,-428,594,1022
4,6ª a 9ª Fundamental,1416,"Gerentes De Operações De Serviços Em Empresa De Transporte, De Comunicação E De Logística (Armazenagem E Distribuição)",2652.499580020494,-224,438,662
4,6ª a 9ª Fundamental,1417,Gerentes De Operações De Serviços Em Instituição De Intermediação Financeira,3713.5892051547185,-19,22,41
4,6ª a 9ª Fundamental,1418,Gerentes Operacionais Da Aviação Civil,2728.584753417969,3,6,3
4,6ª a 9ª Fundamental,1421,"Gerentes Administrativos, Financeiros, De Riscos E Afins",4157.686299152524,-803,1518,2321
4,6ª a 9ª Fundamental,1422,Gerentes De Recursos Humanos E De Relações Do Trabalho,2546.499020469876,-30,67,97
4,6ª a 9ª Fundamental,1423,"Gerentes De Comercialização, Marketing E Comunicação",2764.9962566027953,-809,1149,1958
4,6ª a 9ª Fundamental,1424,Gerentes De Suprimentos E Afins,2618.338555695444,-62,121,183
4,6ª a 9ª Fundamental,1425,Gerentes De Tecnologia Da Informação,4042.6760342068146,-25,28,53
4,6ª a 9ª Fundamental,1426,Gerentes De Pesquisa E Desenvolvimento E Afins,5036.971860532408,-11,8,19
4,6ª a 9ª Fundamental,1427,Gerentes De Manutenção E Afins,3222.1110702857113,-101,150,251
4,6ª a 9ª Fundamental,2011,Profissionais Da Biotecnologia,1305.776025390625,-2,4,6
4,6ª a 9ª Fundamental,2012,Profissionais Da Metrologia,1414.8883056640625,-2,1,3
4,6ª a 9ª Fundamental,2021,"Engenheiros De Controle E Automação, Engenheiros Mecatrônicos E Afins",4930.503326416016,1,6,5
4,6ª a 9ª Fundamental,2030,Pesquisadores Das Ciências Biológicas,1924.2200113932292,-4,0,4
4,6ª a 9ª Fundamental,2032,Pesquisadores De Engenharia E Tecnologia,5558.1333414713545,-2,2,4
4,6ª a 9ª Fundamental,2033,Pesquisadores Das Ciências Da Saúde,1586.8049926757813,2,2,0
4,6ª a 9ª Fundamental,2034,Pesquisadores Das Ciências Da Agricultura,1561.210001627604,0,2,2
4,6ª a 9ª Fundamental,2035,Pesquisadores Das Ciências Sociais E Humanas,3311.8999837239585,-1,2,3
4,6ª a 9ª Fundamental,2111,Profissionais Da Matemática,1840.3099221622242,5,13,8
4,6ª a 9ª Fundamental,2112,Profissionais De Estatística E Afins,1307.75,-1,0,1
4,6ª a 9ª Fundamental,2122,Engenheiros Em Computação,6540.72998046875,1,2,1
4,6ª a 9ª Fundamental,2123,Administradores De Tecnologia Da Informação,2032.505879775135,30,63,33
4,6ª a 9ª Fundamental,2124,Analistas De Tecnologia Da Informação,3157.7457763994203,-18,196,214
4,6ª a 9ª Fundamental,2132,Químicos,1899.2573252895422,-1,12,13
4,6ª a 9ª Fundamental,2134,"Geólogos, Oceanógrafos, Geofísicos E Afins",1473.7225036621094,-1,2,3
4,6ª a 9ª Fundamental,2140,Engenheiros Ambientais E Afins,2763.139071377841,-4,5,9
4,6ª a 9ª Fundamental,2141,Arquitetos E Urbanistas,1440.0012715657551,-5,17,22
4,6ª a 9ª Fundamental,2142,Engenheiros Civis E Afins,3600.8682892281054,-21,50,71
4,6ª a 9ª Fundamental,2143,"Engenheiros Eletricistas, Eletrônicos E Afins",1589.3914923440705,-3,75,78
4,6ª a 9ª Fundamental,2144,Engenheiros Mecânicos E Afins,2435.3924815784803,-1,12,13
4,6ª a 9ª Fundamental,2145,Engenheiros Químicos E Afins,3555.7766723632813,3,5,2
4,6ª a 9ª Fundamental,2146,"Engenheiros Metalurgistas, De Materiais E Afins",1568.9299926757813,1,3,2
4,6ª a 9ª Fundamental,2147,Engenheiros De Minas E Afins,4921.965026855469,-2,0,2
4,6ª a 9ª Fundamental,2149,"Engenheiros De Produção, Qualidade, Segurança E Afins",7376.875264765178,6,52,46
4,6ª a 9ª Fundamental,2151,Oficiais De Convés E Afins,2189.5672064359965,-11,36,47
4,6ª a 9ª Fundamental,2152,Oficiais De Máquinas Da Marinha Mercante,2229.1791585286455,0,7,7
4,6ª a 9ª Fundamental,2153,Profissionais Da Pilotagem Aeronáutica,3584.078898111979,-3,3,6
4,6ª a 9ª Fundamental,2211,Biólogos E Afins,1727.3295043945313,-2,9,11
4,6ª a 9ª Fundamental,2212,Biomédicos,1866.8612365722656,0,4,4
4,6ª a 9ª Fundamental,2221,Engenheiros Agrossilvipecuários,2351.3054638671874,-1,25,26
4,6ª a 9ª Fundamental,2222,Engenheiros De Alimentos E Afins,1316.239990234375,2,2,0
4,6ª a 9ª Fundamental,2232,Cirurgiões-Dentistas,1366.2475077311199,0,9,9
4,6ª a 9ª Fundamental,2233,Veterinários E Zootecnistas,2565.908020917107,-5,10,15
4,6ª a 9ª Fundamental,2234,Farmacêuticos,2307.5466134132744,-2,120,122
4,6ª a 9ª Fundamental,2235,Enfermeiros E Afins,3935.836824403587,-42,52,94
4,6ª a 9ª Fundamental,2236,Fisioterapeutas,3207.2787995515046,-1,14,15
4,6ª a 9ª Fundamental,2237,Nutricionistas,1733.4579126602564,2,98,96
4,6ª a 9ª Fundamental,2238,Fonoaudiólogos,1341.3922254774307,-7,1,8
4,6ª a 9ª Fundamental,2239,"Terapeutas Ocupacionais, Ortoptistas E Psicomotricistas",1992.9266764322917,-1,1,2
4,6ª a 9ª Fundamental,2241,Profissionais Da Educação Física,6595.562076279267,-23,69,92
4,6ª a 9ª Fundamental,2251,Médicos Clínicos,3281.888929524497,0,24,24
4,6ª a 9ª Fundamental,2252,Médicos Em Especialidades Cirúrgicas,2696.268334282769,-5,2,7
4,6ª a 9ª Fundamental,2263,"Profissionais Das Terapias Criativas,Equoterápicas E Naturológicas",1500,0,2,2
4,6ª a 9ª Fundamental,2311,Professores De Nível Superior Na Educação Infantil,1798.997110293359,-17,22,39
4,6ª a 9ª Fundamental,2312,Professores De Nível Superior Do Ensino Fundamental (Primeira A Quarta Séries),1364.3031456115398,-55,32,87
4,6ª a 9ª Fundamental,2313,Professores De Nível Superior No Ensino Fundamental De Quinta A Oitava Série,1155.9366473635037,-7,20,27
4,6ª a 9ª Fundamental,2321,Professores Do Ensino Médio,3540.7417466152046,-23,10,33
4,6ª a 9ª Fundamental,2331,Professores Do Ensino Profissional,1816.086669921875,0,6,6
4,6ª a 9ª Fundamental,2332,Instrutores De Ensino Profissional,2906.807560311897,-69,139,208
4,6ª a 9ª Fundamental,2341,"Professores De Matemática, Estatística E Informática Do Ensino Superior",4515.3450927734375,-3,0,3
4,6ª a 9ª Fundamental,2344,Professores De Ciências Biológicas E Da Saúde Do Ensino Superior,2464.4708332262544,-2,9,11
4,6ª a 9ª Fundamental,2345,Professores Na Área De Formação Pedagógica Do Ensino Superior,1332.11225121816,-11,4,15
4,6ª a 9ª Fundamental,2346,Professores Nas Áreas De Língua E Literatura Do Ensino Superior,3130.443352593316,2,11,9
4,6ª a 9ª Fundamental,2347,Professores De Ciências Humanas Do Ensino Superior,943.401116265191,-3,1,4
4,6ª a 9ª Fundamental,2348,"Professores De Ciências Econômicas, Administrativas E Contábeis Do Ensino Superior",2320.3333333333335,-1,1,2
4,6ª a 9ª Fundamental,2349,Professores De Artes Do Ensino Superior,7416,-1,0,1
4,6ª a 9ª Fundamental,2392,Professores De Educação Especial,1521.1175435384116,-7,7,14
4,6ª a 9ª Fundamental,2394,"Programadores, Avaliadores E Orientadores De Ensino",1568.8782041155555,-44,89,133
4,6ª a 9ª Fundamental,2410,Advogados,3304.5241275955555,-7,22,29
4,6ª a 9ª Fundamental,2412,Procuradores E Advogados Públicos,2300,0,1,1
4,6ª a 9ª Fundamental,2413,Tabeliães E Registradores,2002.2988925509983,-4,6,10
4,6ª a 9ª Fundamental,2422,Membros Do Ministério Público,1629.739990234375,0,1,1
4,6ª a 9ª Fundamental,2429,Profissionais Da Inteligência,1309.469970703125,1,1,0
4,6ª a 9ª Fundamental,2511,Profissionais Em Pesquisa E Análise Antropológica Sociológica,1208.9285714285716,-4,2,6
4,6ª a 9ª Fundamental,2512,Economistas,2764.405351184663,1,18,17
4,6ª a 9ª Fundamental,2515,Psicólogos E Psicanalistas,2620.4574432373047,-4,8,12
4,6ª a 9ª Fundamental,2516,Assistentes Sociais E Economistas Domésticos,1738.271629539696,0,20,20
4,6ª a 9ª Fundamental,2521,Administradores,3584.06661867267,-137,521,658
4,6ª a 9ª Fundamental,2522,Contadores E Afins,2108.805931492856,-31,108,139
4,6ª a 9ª Fundamental,2523,Secretárias(Os) Executivas(Os) E Afins,1712.6588381980364,-105,560,665
4,6ª a 9ª Fundamental,2524,Profissionais De Recursos Humanos,2094.35521232557,13,86,73
4,6ª a 9ª Fundamental,2525,Profissionais De Administração Ecônomico-Financeira,1657.2281552491022,-22,51,73
4,6ª a 9ª Fundamental,2526,Profissionais Da Administração Dos Serviços De Segurança,3277.1349487304688,0,2,2
4,6ª a 9ª Fundamental,2527,"Profissionais De Planejamento, Programação E Controles Logisticos",5373.182176978701,-2,52,54
4,6ª a 9ª Fundamental,2531,Profissionais De Publicidade,2868.183917729048,21,98,77
4,6ª a 9ª Fundamental,2532,Profissionais De Comercializacão E Consultoria De Serviços Bancários,2418.0839294644975,-1,92,93
4,6ª a 9ª Fundamental,2533,"Corretores De Valores, Ativos Financeiros, Mercadorias E Derivativos",1567.7695423473012,-2,10,12
4,6ª a 9ª Fundamental,2534,Profissionais De Mídias Digitais E Afins,2125.75,6,11,5
4,6ª a 9ª Fundamental,2543,Auditores Fiscais Do Trabalho,1305.3223305184144,13,620,607
4,6ª a 9ª Fundamental,2544,Fiscais De Tributos Estaduais E Municipais,1220.6768209284003,4,17,13
4,6ª a 9ª Fundamental,2545,Profissionais Da Fiscalização De Atividades Urbanas,1364.4296601350643,29,75,46
4,6ª a 9ª Fundamental,2611,Profissionais Do Jornalismo,1726.8770953028557,-28,115,143
4,6ª a 9ª Fundamental,2612,Profissionais Da Informação,1869.0991381690617,8,20,12
4,6ª a 9ª Fundamental,2613,Arquivistas E Museólogos,1352.5963232719291,1,38,37
4,6ª a 9ª Fundamental,2614,"Filólogos,Tradutores ,Intérpretes E Afins",2434.48334757487,-4,3,7
4,6ª a 9ª Fundamental,2615,Profissionais Da Escrita,2420.4266764322915,-2,7,9
4,6ª a 9ª Fundamental,2616,Editores,2326.176676432292,0,2,2
4,6ª a 9ª Fundamental,2617,"Locutores, Comentaristas E Repórteres De Mídias Audiovisuais",1964.0982035916095,-41,151,192
4,6ª a 9ª Fundamental,2618,Fotógrafos Profissionais,1599.7116435502423,-1,22,23
4,6ª a 9ª Fundamental,2619,Assistentes De Direção (Tv) E Continuístas,1707.9899698893228,-2,1,3
4,6ª a 9ª Fundamental,2621,Produtores Artísticos E Culturais,1502.5078535137757,0,21,21
4,6ª a 9ª Fundamental,2622,Diretores De Espetáculos E Afins,1551.2883436414932,-3,2,5
4,6ª a 9ª Fundamental,2623,Cenógrafos,2123.235097503662,1,8,7
4,6ª a 9ª Fundamental,2624,"Artistas Visuais,Desenhistas Industriais E Conservadores-Restauradores De Bens Culturais",1612.769122296833,11,232,221
4,6ª a 9ª Fundamental,2625,Atores,1468.0641577378758,-41,6,47
4,6ª a 9ª Fundamental,2626,"Músicos Compositores, Arranjadores, Regentes E Musicólogos",1219.0888849104413,-5,75,80
4,6ª a 9ª Fundamental,2627,Músicos Intérpretes,1391.0516516279597,-29,138,167
4,6ª a 9ª Fundamental,2628,Artistas Da Dança (Exceto Dança Tradicional E Popular),1095.8056236902873,-6,10,16
4,6ª a 9ª Fundamental,2629,Designer De Interiores De Nível Superior,1671.8300048828125,3,4,1
4,6ª a 9ª Fundamental,2631,"Ministros De Culto, Missionários, Teólogos E Profissionais Assemelhados",2285.8115173339843,-11,9,20
4,6ª a 9ª Fundamental,2711,Chefes De Cozinha E Afins,2090.8795141323963,-369,654,1023
4,6ª a 9ª Fundamental,3001,Técnicos Em Mecatrônica,1830.525986792336,-2,35,37
4,6ª a 9ª Fundamental,3003,Técnicos Em Eletromecânica,2286.2529665596835,-4,217,221
4,6ª a 9ª Fundamental,3011,Técnicos De Laboratório Industrial,2040.675133054262,-132,957,1089
4,6ª a 9ª Fundamental,3012,Técnicos De Apoio À Bioengenharia,1500,1,1,0
4,6ª a 9ª Fundamental,3111,Técnicos Químicos,1824.9411363961963,-35,69,104
4,6ª a 9ª Fundamental,3112,"Técnicos De Produção De Indústrias Químicas, Petroquímicas, Refino De Petróleo, Gás E Afins",2801.4299665178573,-3,2,5
4,6ª a 9ª Fundamental,3113,"Técnicos Em Materiais, Produtos Cerâmicos E Vidros",1745.4615671258223,-1,9,10
4,6ª a 9ª Fundamental,3114,Técnicos Em Fabricação De Produtos Plásticos E De Borracha,1656.0915885914837,-95,207,302
4,6ª a 9ª Fundamental,3115,"Técnicos Em Controle Ambiental, Utilidades E Tratamento De Efluentes",1634.4809173568108,-6,179,185
4,6ª a 9ª Fundamental,3116,Técnicos Têxteis,2310.6581927490233,-6,12,18
4,6ª a 9ª Fundamental,3117,Coloristas,3062.578064708543,-132,2341,2473
4,6ª a 9ª Fundamental,3121,Técnicos Em Construção Civil (Edificações),4046.0749078489916,22,589,567
4,6ª a 9ª Fundamental,3122,Técnicos Em Construção Civil (Obras De Infraestrutura),1909.3237233479817,-1,312,313
4,6ª a 9ª Fundamental,3123,Técnicos Em Geomática,2063.763029850698,-70,2536,2606
4,6ª a 9ª Fundamental,3131,Técnicos Em Eletricidade E Eletrotécnica,3518.0867373777123,-472,1529,2001
4,6ª a 9ª Fundamental,3132,Técnicos Em Eletrônica,2084.588844514183,-136,1155,1291
4,6ª a 9ª Fundamental,3133,Técnicos Em Telecomunicações,1521.45152042539,48,903,855
4,6ª a 9ª Fundamental,3134,Técnicos Em Calibração E Instrumentação,2650.124389483668,-88,397,485
4,6ª a 9ª Fundamental,3135,Técnicos Em Fotônica,1508.2822199745783,15,165,150
4,6ª a 9ª Fundamental,3141,"Técnicos Mecânicos Na Fabricação E Montagem De Máquinas, Sistemas E Instrumentos",1799.0663871143036,-172,1481,1653
4,6ª a 9ª Fundamental,3142,Técnicos Mecânicos (Ferramentas),3243.7750775318464,-22,80,102
4,6ª a 9ª Fundamental,3143,Técnicos Em Mecânica Veicular,2157.7359118516456,1,109,108
4,6ª a 9ª Fundamental,3144,"Técnicos Mecânicos Na Manutenção De Máquinas, Sistemas E Instrumentos",2006.7870295887,-18,385,403
4,6ª a 9ª Fundamental,3146,Técnicos Em Metalurgia (Estruturas Metálicas),8601.41725955231,-24,118,142
4,6ª a 9ª Fundamental,3147,Técnicos Em Siderurgia,2560.827317161212,-5,31,36
4,6ª a 9ª Fundamental,3148,Especialistas Em Inspeções Industriais,3202.015137939453,1,9,8
4,6ª a 9ª Fundamental,3161,Técnicos Em Geologia,1626.3219871558504,17,69,52
4,6ª a 9ª Fundamental,3163,Técnicos Em Mineração,1745.7519917284321,-8,14,22
4,6ª a 9ª Fundamental,3171,Técnicos De Desenvolvimento De Sistemas E Aplicações,1711.4654068255459,38,269,231
4,6ª a 9ª Fundamental,3172,Técnicos De Suporte E Monitoração Ao Usuário De Tecnologia Da Informação.,1277.323288777343,83,839,756
4,6ª a 9ª Fundamental,3180,"Desenhistas Técnicos, Em Geral",2400.255844591065,-13,67,80
4,6ª a 9ª Fundamental,3181,Desenhistas Técnicos Da Construção Civil E Arquitetura,1765.7553762708392,-8,40,48
4,6ª a 9ª Fundamental,3182,Desenhistas Técnicos Da Mecânica,797.5587297061394,38,251,213
4,6ª a 9ª Fundamental,3183,"Desenhistas Técnicos Em Eletricidade, Eletrônica, Eletromecânica, Calefação, Ventilação E Refrigeração",1509.5213717523898,4,26,22
4,6ª a 9ª Fundamental,3184,Desenhistas Técnicos De Produtos E Serviços Diversos,1159.8415265845276,72,158,86
4,6ª a 9ª Fundamental,3185,Desenhistas Projetistas De Construção Civil E Arquitetura,1865.0074285372882,-5,38,43
4,6ª a 9ª Fundamental,3186,Desenhistas Projetistas Da Mecânica,3891.893458598369,-12,33,45
4,6ª a 9ª Fundamental,3187,Desenhistas Projetistas Da Eletrônica,2067.985370342548,-1,6,7
4,6ª a 9ª Fundamental,3188,Desenhistas Projetistas E Modelistas De Produtos E Serviços Diversos,2677.103210473842,-93,155,248
4,6ª a 9ª Fundamental,3191,Técnicos Do Vestuário,1639.326693627142,-9,15,24
4,6ª a 9ª Fundamental,3192,Técnicos Do Mobiliário E Afins,1882.58478515625,-3,11,14
4,6ª a 9ª Fundamental,3201,Técnicos Em Biologia,1769.0275531843595,-3,17,20
4,6ª a 9ª Fundamental,3211,Técnicos Agrícolas,2348.828821573544,-69,375,444
4,6ª a 9ª Fundamental,3212,Técnicos Florestais,1477.723677257191,110,649,539
4,6ª a 9ª Fundamental,3213,Técnicos Em Aqüicultura,1298.014903157552,-5,13,18
4,6ª a 9ª Fundamental,3221,Tecnólogos E Técnicos Em Terapias Complementares E Estéticas,1434.7461866989636,-34,103,137
4,6ª a 9ª Fundamental,3222,Técnicos E Auxiliares De Enfermagem,1776.518134585463,-662,393,1055
4,6ª a 9ª Fundamental,3223,Técnicos Em Óptica E Optometria,1534.174281529018,-4,12,16
4,6ª a 9ª Fundamental,3224,Técnicos De Odontologia,1501.7741117588737,-112,364,476
4,6ª a 9ª Fundamental,3225,Técnicos Em Próteses Ortopédicas,2026.950400390625,-5,10,15
4,6ª a 9ª Fundamental,3226,Técnicos De Imobilizações Ortopédicas,1752.094970703125,-2,1,3
4,6ª a 9ª Fundamental,3231,Técnicos Em Pecuária,1688.541604746943,23,69,46
4,6ª a 9ª Fundamental,3241,Tecnólogos E Técnicos Em Métodos De Diagnósticos E Terapêutica,1851.3120860417685,-34,19,53
4,6ª a 9ª Fundamental,3242,Técnicos De Laboratórios De Saúde E Bancos De Sangue,1955.3301804976031,-23,20,43
4,6ª a 9ª Fundamental,3250,"Enólogos, Perfumistas E Aromistas",1443.1549997637348,-9,28,37
4,6ª a 9ª Fundamental,3251,Técnico Em Farmácia E Em Manipulação Farmacêutica,1632.2615997516798,-10,56,66
4,6ª a 9ª Fundamental,3252,"Técnicos Em Produção, Conservação  E De Qualidade De Alimentos",1785.347232431931,-42,358,400
4,6ª a 9ª Fundamental,3253,Técnicos De Apoio À Biotecnologia,1956,0,1,1
4,6ª a 9ª Fundamental,3281,Técnicos Em Necrópsia E Taxidermistas,1848.9924926757813,2,3,1
4,6ª a 9ª Fundamental,3311,Professores De Nível Médio Na Educação Infantil,1540.4917486611762,-214,651,865
4,6ª a 9ª Fundamental,3312,Professores De Nível Médio No Ensino Fundamental,8920.838334038144,0,27,27
4,6ª a 9ª Fundamental,3313,Professores De Nível Médio No Ensino Profissionalizante,1592.115478515625,-7,3,10
4,6ª a 9ª Fundamental,3321,Professores Leigos No Ensino Fundamental,1570.878061082628,-14,11,25
4,6ª a 9ª Fundamental,3322,Professores Práticos No Ensino Profissionalizante,2183.2567138671875,-5,2,7
4,6ª a 9ª Fundamental,3331,Instrutores E Professores De Cursos Livres,2044.1393888342625,-66,234,300
4,6ª a 9ª Fundamental,3341,Inspetores De Alunos E Afins,1338.7597311360585,-140,2300,2440
4,6ª a 9ª Fundamental,3411,"Pilotos De Aviação Comercial, Mecânicos De Vôo E Afins",3026.1688902431865,4,17,13
4,6ª a 9ª Fundamental,3412,"Técnicos Marítimos, Fluviários E Pescadores De Convés",2984.8817572085363,-40,541,581
4,6ª a 9ª Fundamental,3413,Técnicos Marítimos E Fluviários De Máquinas,4347.679678843584,-72,297,369
4,6ª a 9ª Fundamental,3421,Especialistas Em Logística De Transportes,4641.137539291071,8,1313,1305
4,6ª a 9ª Fundamental,3422,Despachantes Aduaneiros,1398.9961723230358,-18,183,201
4,6ª a 9ª Fundamental,3423,Técnicos Em Transportes Rodoviários,2765.2433232051867,-586,724,1310
4,6ª a 9ª Fundamental,3424,Técnicos Em Transportes Metroferroviários,1954.9280319162283,-73,58,131
4,6ª a 9ª Fundamental,3425,Técnicos Em Transportes Aéreos,1592.3626342190066,-8,26,34
4,6ª a 9ª Fundamental,3426,Técnicos Em Transportes Por Vias Navegáveis E Operações Portuárias,2144.2266092503323,-9,22,31
4,6ª a 9ª Fundamental,3511,Técnicos Em Contabilidade,1925.5651692708334,-12,24,36
4,6ª a 9ª Fundamental,3513,Técnicos Em Administração,2032.728971313567,2,90,88
4,6ª a 9ª Fundamental,3514,Serventuários Da Justiça E Afins,1991.2105510330114,-24,81,105
4,6ª a 9ª Fundamental,3515,"Técnicos Em Secretariado, Taquígrafos E Estenotipistas",1467.1982453188848,-89,246,335
4,6ª a 9ª Fundamental,3516,Técnicos Em Segurança Do Trabalho,4658.262442284554,-1,454,455
4,6ª a 9ª Fundamental,3517,Técnicos De Seguros E Afins,1763.934620568363,-35,106,141
4,6ª a 9ª Fundamental,3522,Agentes Da Saúde E Do Meio Ambiente,1918.919041917737,-61,419,480
4,6ª a 9ª Fundamental,3523,Agentes  Fiscais Metrológicos E De Qualidade,1976.738240843715,-27,89,116
4,6ª a 9ª Fundamental,3524,Profissionais De Direitos Autorais E De Avaliacão De Produtos Dos Meios De Comunicação,1490.3566589355469,-1,6,7
4,6ª a 9ª Fundamental,3532,Técnicos Em Operações E Serviços Bancários,2154.851895679459,-22,10,32
4,6ª a 9ª Fundamental,3541,Especialistas Em Promoção De Produtos E Vendas,1873.0275303197316,-361,3733,4094
4,6ª a 9ª Fundamental,3542,Compradores,2875.3308706040925,-150,241,391
4,6ª a 9ª Fundamental,3543,Analistas De Comércio Exterior,3918.036686197917,-3,6,9
4,6ª a 9ª Fundamental,3544,Leiloeiros E Avaliadores,1783.2472573546536,-11,23,34
4,6ª a 9ª Fundamental,3545,Corretores De Seguros,2653.4019775390625,3,4,1
4,6ª a 9ª Fundamental,3546,Corretores De Imóveis E De Grãos,1836.5508925494025,-2,8,10
4,6ª a 9ª Fundamental,3547,Representantes Comerciais Autônomos,1557.9923360188802,4,32,28
4,6ª a 9ª Fundamental,3548,Técnicos Em Serviços De Turismo E Organização De Eventos,1473.7729150721334,-22,177,199
4,6ª a 9ª Fundamental,3711,Técnicos Em Biblioteconomia,1161.3467852783203,-4,24,28
4,6ª a 9ª Fundamental,3713,Técnicos Em Artes Gráficas,1768.444824572577,-2,18,20
4,6ª a 9ª Fundamental,3714,Recreadores,1619.3438552808752,-80,803,883
4,6ª a 9ª Fundamental,3721,Captadores De Imagens Em Movimento,1741.5388927259676,-26,39,65
4,6ª a 9ª Fundamental,3722,Operadores De Rede De Teleprocessamento E Afins,1499.2235263001685,14,61,47
4,6ª a 9ª Fundamental,3731,Técnicos De Operação De Registros Sonoro/Audiovisuais,2429.193944747523,-71,86,157
4,6ª a 9ª Fundamental,3732,Supervisores Operacionais E Técnicos Em Mídias Audiovisuais,3589.2611099281403,-35,11,46
4,6ª a 9ª Fundamental,3741,Técnicos Em Áudio,1500.3081995157386,-70,384,454
4,6ª a 9ª Fundamental,3742,Técnicos Em Cenografia,2952.0241467320498,-9,74,83
4,6ª a 9ª Fundamental,3743,Técnicos Em Operação De Aparelhos De Projeção,1654.142526799982,-8,13,21
4,6ª a 9ª Fundamental,3744,"Técnicos Em Montagem, Edição E Finalização De Mídia Audiovisual",1754.3838920090777,-50,451,501
4,6ª a 9ª Fundamental,3751,"Designers De Interiores, De Vitrines E Visual Merchandiser E Afins (Nível Médio)",3580.08037806706,-39,112,151
4,6ª a 9ª Fundamental,3761,Dançarinos Tradicionais E Populares,1148.75342760588,-19,1,20
4,6ª a 9ª Fundamental,3762,Artistas De Circo (Circenses),1339.0179241362073,0,25,25
4,6ª a 9ª Fundamental,3763,"Apresentadores De Eventos, Programas E Espetáculos",1626.6568736710087,-2,28,30
4,6ª a 9ª Fundamental,3764,Modelos,1562.2166748046875,2,3,1
4,6ª a 9ª Fundamental,3771,Atletas Profissionais,5567.645588172253,90,738,648
4,6ª a 9ª Fundamental,3772,Árbitros Desportivos,1571.7887382507324,2,7,5
4,6ª a 9ª Fundamental,3911,"Planejadores, Programadores E Controladores De Produção E Manutenção",6997.5093192222475,-490,3043,3533
4,6ª a 9ª Fundamental,3912,Técnicos De Controle Da Produção,2035.1173203362605,-442,3943,4385
4,6ª a 9ª Fundamental,3951,Técnicos De Apoio Em Pesquisa E Desenvolvimento,1733.5215144878357,-30,212,242
4,6ª a 9ª Fundamental,4101,Supervisores Administrativos,2346.380530392034,-1886,3358,5244
4,6ª a 9ª Fundamental,4102,"Supervisores De Serviços Financeiros, De Câmbio E De Controle",2301.5316860253583,-313,873,1186
4,6ª a 9ª Fundamental,4110,"Agentes, Assistentes E Auxiliares Administrativos",1581.9416326974574,3800,75943,72143
4,6ª a 9ª Fundamental,4121,Operadores De Equipamentos De Entrada E Transmissão De Dados,1350.573989830696,-27,204,231
4,6ª a 9ª Fundamental,4122,Contínuos,2076.0349439500596,-1068,8401,9469
4,6ª a 9ª Fundamental,4131,Auxiliares De Contabilidade,2046.334357404523,-170,573,743
4,6ª a 9ª Fundamental,4132,Escriturários De Serviços Bancários,1803.342562115414,-367,3084,3451
4,6ª a 9ª Fundamental,4141,Almoxarifes E Armazenistas,1639.1247971645146,2724,71298,68574
4,6ª a 9ª Fundamental,4142,Apontadores E Conferentes,2376.9439315103823,-2656,10150,12806
4,6ª a 9ª Fundamental,4151,"Auxiliares De Serviços De Documentação, Informação E Pesquisa",1567.698290759233,-48,289,337
4,6ª a 9ª Fundamental,4152,"Trabalhadores Nos Serviços De Classificação E Entregas De Correspondências, Encomendas E Publicações",1704.3697989551729,-196,665,861
4,6ª a 9ª Fundamental,4201,Supervisores De Atendimento Ao Público E De Pesquisa,1833.8250398905823,-217,148,365
4,6ª a 9ª Fundamental,4211,Caixas E Bilheteiros (Exceto Caixa De Banco),1430.820777124126,-1378,19397,20775
4,6ª a 9ª Fundamental,4212,Coletadores De Apostas E De Jogos,911.0505959787677,-36,139,175
4,6ª a 9ª Fundamental,4213,Cobradores E Afins,1806.8784058249978,-288,870,1158
4,6ª a 9ª Fundamental,4221,Recepcionistas,1437.9698113686134,-1516,6497,8013
4,6ª a 9ª Fundamental,4222,Operadores De Telefonia,1359.807653727617,-209,211,420
4,6ª a 9ª Fundamental,4223,Operadores De Telemarketing E Afins,1353.7284507928905,-40,1974,2014
4,6ª a 9ª Fundamental,4231,Despachantes Documentalistas E Afins,1554.1458474662743,-63,250,313
4,6ª a 9ª Fundamental,4241,Entrevistadores E Recenseadores,1320.100488286722,-8,141,149
4,6ª a 9ª Fundamental,4242,Aplicadores De Provas E Afins,1672.204539905895,2,7,5
4,6ª a 9ª Fundamental,5101,"Supervisores Dos Serviços De Transporte, Turismo, Hotelaria E Administração De Edifícios",2841.8206562056575,-449,584,1033
4,6ª a 9ª Fundamental,5102,Supervisores De Lavanderia,1864.9161891880992,-139,100,239
4,6ª a 9ª Fundamental,5103,"Supervisores Dos Serviços De Proteção, Segurança E Outros",2406.618799845378,-140,128,268
4,6ª a 9ª Fundamental,5111,Trabalhadores De Segurança E Atendimento Aos Usuários Nos Transportes,1296.0641409606358,-13,142,155
4,6ª a 9ª Fundamental,5112,Fiscais E Cobradores Dos Transportes Coletivos,1552.763035871297,-3951,1983,5934
4,6ª a 9ª Fundamental,5114,Guias De Turismo,1193.228804381548,22,124,102
4,6ª a 9ª Fundamental,5115,Condutores De Turismo,1336.268052116843,0,21,21
4,6ª a 9ª Fundamental,5121,Trabalhadores Dos Serviços Domésticos Em Geral,1749.605916221765,462,2969,2507
4,6ª a 9ª Fundamental,5131,Mordomos E Governantas,1504.1778061930443,-124,451,575
4,6ª a 9ª Fundamental,5132,Cozinheiros,4657.8658813216025,-6232,55445,61677
4,6ª a 9ª Fundamental,5133,"Camareiros, Roupeiros E Afins",1395.9782736228274,-1444,13352,14796
4,6ª a 9ª Fundamental,5134,"Trabalhadores No Atendimento Em Estabelecimentos De Serviços De Alimentação, Bebidas E Hotelaria",1661.1839592782464,-4827,51436,56263
4,6ª a 9ª Fundamental,5135,Trabalhadores Auxiliares Nos Serviços De Alimentação,1475.4180837704,338,67600,67262
4,6ª a 9ª Fundamental,5136,"Churrasqueiros, Pizzaiolos E Sushimen",1752.6910683587394,-389,4090,4479
4,6ª a 9ª Fundamental,5141,Trabalhadores Nos Serviços De Administração De Edifícios,1632.9142750766828,-2295,26763,29058
4,6ª a 9ª Fundamental,5142,"Trabalhadores Nos Serviços De Coleta De Resíduos, De Limpeza E Conservação De Áreas Públicas",161250.03687921722,-314,82176,82490
4,6ª a 9ª Fundamental,5143,Trabalhadores Nos  Serviços De Manutenção De Edificações,1650.2733276603728,13430,393533,380103
4,6ª a 9ª Fundamental,5151,Trabalhadores Em Serviços De Promoção E Apoio À Saúde,1352.6808464608303,30,1350,1320
4,6ª a 9ª Fundamental,5152,Auxiliares De Laboratório Da Saúde,1949.526588193838,-162,774,936
4,6ª a 9ª Fundamental,5153,"Trabalhadores De Atenção, Defesa E Proteção A Pessoas Em Situação De Risco E Adolescentes Em Conflito Com A Lei",1485.6674292230325,-98,523,621
4,6ª a 9ª Fundamental,5161,Trabalhadores Nos Serviços De Embelezamento E Higiene,1345.0079231559787,-362,363,725
4,6ª a 9ª Fundamental,5162,"Cuidadores De Crianças, Jovens, Adultos E Idosos",1558.1135252200415,-30,3179,3209
4,6ª a 9ª Fundamental,5163,"Tintureiros, Lavadeiros E Afins, A Máquina",1602.435237223084,-925,10250,11175
4,6ª a 9ª Fundamental,5164,"Lavadores E Passadores De Roupa, A Mão",1365.0432534160072,-201,701,902
4,6ª a 9ª Fundamental,5165,Trabalhadores Dos Serviços Funerários,1445.6621310567018,-14,648,662
4,6ª a 9ª Fundamental,5166,Trabalhadores Auxiliares Dos Serviços Funerários,1644.7418636747657,80,733,653
4,6ª a 9ª Fundamental,5169,Trabalhadores Nos Serviços De Arte Corporal,1320,1,1,0
4,6ª a 9ª Fundamental,5171,"Bombeiros, Salva-Vidas E Afins",3855.3974920461687,-134,607,741
4,6ª a 9ª Fundamental,5172,"Policiais, Guardas-Civis Municipais E Agentes De Trânsito",1638.86863152201,-49,387,436
4,6ª a 9ª Fundamental,5173,Vigilantes E Guardas De Segurança,1768.0391471987489,-4459,12778,17237
4,6ª a 9ª Fundamental,5174,"Porteiros, Vigias E Afins",1679.5379609023967,-8946,50807,59753
4,6ª a 9ª Fundamental,5191,Motociclistas E Ciclistas De Entregas Rápidas,1788.8371690344059,284,7225,6941
4,6ª a 9ª Fundamental,5192,Trabalhadores Da Coleta E Seleção De Material Reciclável,1732.0461332787265,122,3605,3483
4,6ª a 9ª Fundamental,5193,"Trabalhadores De Serviços Veterinários, De Higiene E Estética De Animais Domésticos",1585.5039796585243,-74,1029,1103
4,6ª a 9ª Fundamental,5199,Outros Trabalhadores Dos Serviços,1830.1604759302827,-770,13557,14327
4,6ª a 9ª Fundamental,5201,Supervisores De Vendas E De Prestação De Serviços,1974.4081863232077,-474,477,951
4,6ª a 9ª Fundamental,5211,Operadores Do Comércio Em Lojas E Mercados,1499.447880221921,-6199,151916,158115
4,6ª a 9ª Fundamental,5231,Instaladores De Produtos E Acessórios,1416.663585730422,-100,926,1026
4,6ª a 9ª Fundamental,5241,Vendedores Em Domicílio,1276.0897548974485,-172,1299,1471
4,6ª a 9ª Fundamental,5242,"Vendedores Em Bancas, Quiosques E Barracas",1288.6174472329308,-56,167,223
4,6ª a 9ª Fundamental,5243,Vendedores Ambulantes,1209.5605856123523,-46,215,261
4,6ª a 9ª Fundamental,6110,Produtores Agropecuários Em Geral,1395.6698826594638,-11,505,516
4,6ª a 9ª Fundamental,6120,Produtores Agrícolas Polivalentes,1492.8445325457185,28,641,613
4,6ª a 9ª Fundamental,6121,Produtores Agrícolas Na Cultura De Gramíneas,1573.8607095333903,-4,101,105
4,6ª a 9ª Fundamental,6122,Produtores Agrícolas Na Cultura De Plantas Fibrosas,1100,-2,0,2
4,6ª a 9ª Fundamental,6123,Produtores Agrícolas Na Olericultura,1425.580174198319,11,124,113
4,6ª a 9ª Fundamental,6124,Produtores Agrícolas No Cultivo De Flores E Plantas Ornamentais,1690.8030358782548,16,111,95
4,6ª a 9ª Fundamental,6125,Produtores Agrícolas Na Fruticultura,1354.6739119228168,-16,137,153
4,6ª a 9ª Fundamental,6126,Produtores Agrícolas Na Cultura De Plantas Estimulantes,1221.7305535210505,-3,6,9
4,6ª a 9ª Fundamental,6127,Produtores Agrícolas Na Cultura De Plantas Oleaginosas,1452.8164431322066,-4,12,16
4,6ª a 9ª Fundamental,6128,Produtores De Especiarias E De Plantas Aromáticas E Medicinais,1731.4349975585938,2,3,1
4,6ª a 9ª Fundamental,6130,Produtores Em Pecuária Polivalente,1475.1965037292398,2,61,59
4,6ª a 9ª Fundamental,6131,Produtores Em Pecuária De Animais De Grande Porte,1453.1279793750996,25,206,181
4,6ª a 9ª Fundamental,6132,Produtores Em Pecuária De Animais De Médio Porte,1999.9395493500651,-11,221,232
4,6ª a 9ª Fundamental,6133,Produtores Da Avicultura E Cunicultura,1525.0581403995345,46,922,876
4,6ª a 9ª Fundamental,6134,Produtores De Animais E Insetos Úteis,1649.0050487788037,-1,24,25
4,6ª a 9ª Fundamental,6201,Supervisores Na Exploração Agropecuária,2418.7223212795384,-794,6435,7229
4,6ª a 9ª Fundamental,6210,Trabalhadores Agropecuários Em Geral,1639.479898562641,1812,121051,119239
4,6ª a 9ª Fundamental,6220,Trabalhadores De Apoio À Agricultura,2071.3988737505942,12221,182267,170046
4,6ª a 9ª Fundamental,6221,Trabalhadores Agrícolas Na Cultura De Gramíneas,2584.7146451095414,3031,104925,101894
4,6ª a 9ª Fundamental,6222,Trabalhadores Agrícolas Na Cultura De Plantas Fibrosas,1486.3693126302949,44,894,850
4,6ª a 9ª Fundamental,6223,Trabalhadores Agrícolas Na Olericultura,1309.365509011939,263,7473,7210
4,6ª a 9ª Fundamental,6224,Trabalhadores Agrícolas No Cultivo De Flores E Plantas Ornamentais,1395.5235998273452,118,3701,3583
4,6ª a 9ª Fundamental,6225,Trabalhadores Agrícolas Na Fruticultura,2831.638178827172,2802,102647,99845
4,6ª a 9ª Fundamental,6226,Trabalhadores Agrícolas Nas Culturas De Plantas Estimulantes,1240.4508469213522,913,23896,22983
4,6ª a 9ª Fundamental,6227,Trabalhadores Agrícolas Na Cultura De Plantas Oleaginosas,1542.7622408618067,2318,11636,9318
4,6ª a 9ª Fundamental,6228,Trabalhadores Agrícolas Da Cultura De Especiarias E De Plantas Aromáticas E Medicinais,1351.2284012752866,-11,234,245
4,6ª a 9ª Fundamental,6230,Tratadores Polivalentes De Animais,1710.8237970347889,77,11071,10994
4,6ª a 9ª Fundamental,6231,Trabalhadores Na Pecuária De Animais De Grande Porte,1645.4323295599447,518,31703,31185
4,6ª a 9ª Fundamental,6232,Trabalhadores Na Pecuária De Animais De Médio Porte,1325.4463707969444,359,6790,6431
4,6ª a 9ª Fundamental,6233,Trabalhadores Na Avicultura E Cunicultura,1464.155577530168,1226,22865,21639
4,6ª a 9ª Fundamental,6234,Trabalhadores Na Criação De Insetos E Animais Úteis,1777.0971387457062,-16,107,123
4,6ª a 9ª Fundamental,6301,Supervisores Na Área Florestal E Aqüicultura,2161.3403869709045,-98,451,549
4,6ª a 9ª Fundamental,6310,Pescadores Polivalentes,1288.976670874038,4,120,116
4,6ª a 9ª Fundamental,6311,Pescadores Profissionais Artesanais De Água Doce,1164.2701686171235,20,71,51
4,6ª a 9ª Fundamental,6312,Pescadores De Água Costeira E Alto Mar,9536.320228278812,117,3396,3279
4,6ª a 9ª Fundamental,6313,Criadores De Animais Aquáticos,1673.5023329862556,53,1203,1150
4,6ª a 9ª Fundamental,6314,Trabalhadores De Apoio À Pesca,1634.4315576800345,10,88,78
4,6ª a 9ª Fundamental,6320,Trabalhadores Florestais Polivalentes,1745.5851950421645,153,869,716
4,6ª a 9ª Fundamental,6321,Extrativistas E Reflorestadores De Espécies Produtoras De Madeira,1477.3471547615595,1753,32396,30643
4,6ª a 9ª Fundamental,6322,Extrativistas Florestais De Espécies Produtoras De Gomas E Resinas,1151.20872626685,-332,3209,3541
4,6ª a 9ª Fundamental,6323,"Extrativistas Florestais De Espécies Produtoras De Fibras, Ceras E Óleos",1515.0972681552123,7,4163,4156
4,6ª a 9ª Fundamental,6324,Extrativistas Florestais De Espécies Produtoras De Alimentos Silvestres,1222.9988968397581,-53,289,342
4,6ª a 9ª Fundamental,6325,"Extrativistas Florestais De Espécies Produtoras De Substâncias Aromáticas, Medicinais E Tóxicas",1379.4936005410382,0,186,186
4,6ª a 9ª Fundamental,6326,Carvoejadores,137115.05144294846,417,5371,4954
4,6ª a 9ª Fundamental,6410,Trabalhadores Da Mecanização Agrícola,4693.928600224456,2107,72492,70385
4,6ª a 9ª Fundamental,6420,Trabalhadores Da Mecanização Florestal,2006.0248489823753,254,4243,3989
4,6ª a 9ª Fundamental,6430,Trabalhadores Da Irrigação E Drenagem,2183.24836169241,126,1921,1795
4,6ª a 9ª Fundamental,7101,Supervisores Da Extração Mineral,3273.3071321824577,-74,189,263
4,6ª a 9ª Fundamental,7102,Supervisores Da Construção Civil,3582.2548743556763,-1096,17105,18201
4,6ª a 9ª Fundamental,7111,Trabalhadores Da Extração De Minerais Sólidos,2142.9179495865997,226,3386,3160
4,6ª a 9ª Fundamental,7112,Trabalhadores De Extração De Minerais Sólidos (Operadores De Máquinas),2606.832527190093,45,6476,6431
4,6ª a 9ª Fundamental,7113,Trabalhadores Da Extração De Minerais Líquidos E Gasosos,1888.1251373304847,148,1488,1340
4,6ª a 9ª Fundamental,7114,Garimpeiros E Operadores De Salinas,1356.6957458776392,6,161,155
4,6ª a 9ª Fundamental,7121,Trabalhadores De Beneficiamento De Minérios,1988.7619494518221,102,1543,1441
4,6ª a 9ª Fundamental,7122,Trabalhadores De Beneficiamento De Pedras Ornamentais,1695.551207726711,-192,3587,3779
4,6ª a 9ª Fundamental,7151,Trabalhadores Na Operação De Máquinas De Terraplenagem E Fundações,2700.697437005894,212,39665,39453
4,6ª a 9ª Fundamental,7152,Trabalhadores De Estruturas De Alvenaria,2353.3827422190147,4858,158836,153978
4,6ª a 9ª Fundamental,7153,Montadores De Estruturas De Concreto Armado,2867.0639817842625,1382,36641,35259
4,6ª a 9ª Fundamental,7154,Trabalhadores Na Operação De Máquinas De Concreto Usinado E Afins,2244.871443827408,-314,4498,4812
4,6ª a 9ª Fundamental,7155,"Trabalhadores De Montagem De Estruturas De Madeira, Metal E Compósitos Em Obras Civis",2449.71635995868,2076,76595,74519
4,6ª a 9ª Fundamental,7156,Trabalhadores De Instalações Elétricas,3005.8131428980146,-67,14257,14324
4,6ª a 9ª Fundamental,7157,Aplicadores De Materiais Isolantes,10060.310983198475,42,3237,3195
4,6ª a 9ª Fundamental,7161,Revestidores De Concreto,1912.9301169191956,34,628,594
4,6ª a 9ª Fundamental,7162,Telhadores (Revestimentos Rígidos),1813.4538711602772,-4,171,175
4,6ª a 9ª Fundamental,7163,Vidraceiros (Revestimentos Rígidos),1819.778647857392,-36,2116,2152
4,6ª a 9ª Fundamental,7164,Gesseiros,5774.572646938311,333,6934,6601
4,6ª a 9ª Fundamental,7165,"Aplicadores De Revestimentos Cerâmicos, Pastilhas, Pedras E Madeiras",2360.7332759180663,69,4999,4930
4,6ª a 9ª Fundamental,7166,Pintores De Obras E Revestidores De Interiores (Revestimentos Flexíveis),2045.8508138416798,-197,18653,18850
4,6ª a 9ª Fundamental,7170,Ajudantes De Obras Civis,2039.2174031363672,33079,358917,325838
4,6ª a 9ª Fundamental,7201,"Supervisores De Usinagem, Conformação E Tratamento De Metais",9322.698981532752,-180,659,839
4,6ª a 9ª Fundamental,7202,Supervisores Da Fabricação E Montagem Metalmecânica,5267.041422790798,-125,151,276
4,6ª a 9ª Fundamental,7211,Ferramenteiros E Afins,3315.206324500789,-184,750,934
4,6ª a 9ª Fundamental,7212,Preparadores E Operadores De Máquinas-Ferramenta Convencionais,2655.0906176768726,-1513,5342,6855
4,6ª a 9ª Fundamental,7213,Afiadores E Polidores De Metais,2462.238731404371,-78,2657,2735
4,6ª a 9ª Fundamental,7214,Operadores De Máquinas De Usinagem Cnc,3563.178604536381,-171,942,1113
4,6ª a 9ª Fundamental,7221,Trabalhadores De Forjamento De Metais,2613.671510879814,19,1765,1746
4,6ª a 9ª Fundamental,7222,Trabalhadores De Fundição De Metais Puros E De Ligas Metálicas,1740.0906034392572,83,4494,4411
4,6ª a 9ª Fundamental,7223,Trabalhadores De Moldagem De Metais E De Ligas Metálicas,1974.964995920301,-133,2010,2143
4,6ª a 9ª Fundamental,7224,Trabalhadores De Trefilação E Estiramento De Metais Puros E Ligas Metálicas,3463.262052607628,-44,158,202
4,6ª a 9ª Fundamental,7231,Trabalhadores De Tratamento Térmico De Metais,1817.3944393605684,-41,197,238
4,6ª a 9ª Fundamental,7232,Trabalhadores De Tratamento De Superfícies De Metais E De Compósitos (Termoquímicos),1885.0858277737743,-166,1077,1243
4,6ª a 9ª Fundamental,7233,"Trabalhadores Da Pintura De Equipamentos, Veículos, Estruturas Metálicas E De Compósitos",2253.6084180332614,-605,8340,8945
4,6ª a 9ª Fundamental,7241,Encanadores E Instaladores De Tubulações,2911.190884493407,-44,16337,16381
4,6ª a 9ª Fundamental,7242,Trabalhadores De Traçagem E Montagem De Estruturas Metálicas E De Compósitos,3253.1966878114486,1277,27250,25973
4,6ª a 9ª Fundamental,7243,Trabalhadores De Soldagem E Corte De Ligas Metálicas,4793.257120448778,-626,25892,26518
4,6ª a 9ª Fundamental,7244,Trabalhadores De Caldeiraria E Serralheria,6460.020702227101,-190,15009,15199
4,6ª a 9ª Fundamental,7245,Operadores De Máquinas De Conformação De Metais,2324.2261488023364,-586,2182,2768
4,6ª a 9ª Fundamental,7246,Trançadores E Laceiros De Cabos De Aço,7313.993141167412,-15,47,62
4,6ª a 9ª Fundamental,7250,Ajustadores Mecânicos Polivalentes E Afins,2229.113638920038,-136,2581,2717
4,6ª a 9ª Fundamental,7251,"Montadores De Máquinas, Aparelhos E Acessórios Em Linhas De Montagem",2448.794792230419,-20,1980,2000
4,6ª a 9ª Fundamental,7252,Montadores De Máquinas Industriais,2836.2111897033055,265,7002,6737
4,6ª a 9ª Fundamental,7253,Montadores De Máquinas Pesadas E Equipamentos Agrícolas,2181.1591582698397,-19,589,608
4,6ª a 9ª Fundamental,7254,Mecânicos Montadores De Motores E Turboalimentadores,2291.6258272977866,-8,304,312
4,6ª a 9ª Fundamental,7255,Montadores De Veículos Automotores (Linha De Montagem),1891.0472018873452,-141,420,561
4,6ª a 9ª Fundamental,7256,Montadores De Sistemas E Estruturas De Aeronaves,1581.2437540690103,2,8,6
4,6ª a 9ª Fundamental,7257,Instaladores De Equipamentos De Refrigeração E Ventilação,2654.443402659575,-99,644,743
4,6ª a 9ª Fundamental,7301,Supervisores De Montagens E Instalações Eletroeletrônicas,3702.2717322500625,-30,187,217
4,6ª a 9ª Fundamental,7311,Montadores De Equipamentos Eletroeletrônicos,2199.988495408142,134,10960,10826
4,6ª a 9ª Fundamental,7312,Montadores De Aparelhos De Telecomunicações,1513.6072530110678,-20,110,130
4,6ª a 9ª Fundamental,7313,Instaladores-Reparadores De  Linhas E Equipamentos De Telecomunicações,1482.0462190269411,-176,928,1104
4,6ª a 9ª Fundamental,7321,"Instaladores E Reparadores De Linhas E Cabos Elétricos, Telefônicos E De Comunicação De Dados",1840.0962839560677,-698,6474,7172
4,6ª a 9ª Fundamental,7401,Supervisores Da Mecânica De Precisão E Instrumentos Musicais,2272.6574808756513,-10,2,12
4,6ª a 9ª Fundamental,7411,Mecânicos De Instrumentos De Precisão,1767.254341350923,13,302,289
4,6ª a 9ª Fundamental,7421,Confeccionadores De Instrumentos Musicais,1778.8749958147323,-8,9,17
4,6ª a 9ª Fundamental,7501,Supervisores De Joalheria E Afins,2727,-4,0,4
4,6ª a 9ª Fundamental,7502,"Supervisores De Vidraria, Cerâmica E Afins",2986.54625193278,-14,17,31
4,6ª a 9ª Fundamental,7510,Joalheiros E Lapidadores De Gemas,1672.9716417769623,-17,183,200
4,6ª a 9ª Fundamental,7511,Artesãos De Metais Preciosos E Semi-Preciosos,2398.6035558614644,-64,203,267
4,6ª a 9ª Fundamental,7521,"Sopradores, Moldadores E Modeladores De Vidros E Afins",1868.7745109687821,-11,110,121
4,6ª a 9ª Fundamental,7522,Trabalhadores Da Transformação De Vidros Planos,2282.5707960754066,-21,403,424
4,6ª a 9ª Fundamental,7523,Ceramistas (Preparação E Fabricação),1946.7565100578631,23,6011,5988
4,6ª a 9ª Fundamental,7524,Vidreiros E Ceramistas (Arte E Decoração),3692.818076481514,-55,177,232
4,6ª a 9ª Fundamental,7601,Supervisores Da Indústria Têxtil,7694.491024305813,-276,612,888
4,6ª a 9ª Fundamental,7602,Supervisores Na Indústria Do Curtimento,2804.3024978637695,-6,5,11
4,6ª a 9ª Fundamental,7603,Supervisores Na Confecção Do Vestuário,2566.5009220807187,-252,350,602
4,6ª a 9ª Fundamental,7604,Supervisores Na Confecção De Calçados,2903.305774447414,-306,590,896
4,6ª a 9ª Fundamental,7605,"Supervisores Da Confecção De Artefatos De Tecidos, Couros E Afins",2124.8235983926743,-41,71,112
4,6ª a 9ª Fundamental,7606,Supervisores Das Artes Gráficas,2589.8933743990383,-19,23,42
4,6ª a 9ª Fundamental,7610,Trabalhadores Polivalentes Das Indústrias Têxteis,4525.453593279925,-104,4156,4260
4,6ª a 9ª Fundamental,7611,Trabalhadores Da Classificação De Fibras Têxteis E Lavagem De Lã,1645.047170197925,9,166,157
4,6ª a 9ª Fundamental,7612,Operadores Da Fiação,1519.176236551837,-510,1646,2156
4,6ª a 9ª Fundamental,7613,Operadores De Tear E Máquinas Similares,3159.335439640001,-500,3214,3714
4,6ª a 9ª Fundamental,7614,"Trabalhadores De Acabamento, Tingimento E Estamparia Das Indústrias Têxteis",2897.3060714667154,-280,1774,2054
4,6ª a 9ª Fundamental,7618,Inspetores E Revisores De Produção Têxtil,1822.0469247094504,-528,2496,3024
4,6ª a 9ª Fundamental,7620,Trabalhadores Polivalentes Do Curtimento De Couros E Peles,1534.3514444502214,157,4457,4300
4,6ª a 9ª Fundamental,7621,Trabalhadores Da Preparação Do Curtimento De Couros E Peles,1714.04999280591,-120,286,406
4,6ª a 9ª Fundamental,7622,Trabalhadores Do Curtimento De Couros E Peles,1769.2226738152738,-99,574,673
4,6ª a 9ª Fundamental,7623,Trabalhadores Do Acabamento De Couros E Peles,1930.5399884759613,-200,1123,1323
4,6ª a 9ª Fundamental,7630,Profissionais Polivalentes Da Confecção De Roupas,1615.7488811718229,-568,3007,3575
4,6ª a 9ª Fundamental,7631,Trabalhadores Da Preparação Da Confecção De Roupas,1644.104978110098,-149,11393,11542
4,6ª a 9ª Fundamental,7632,Operadores De Máquinas Para Costura De Peças Do Vestuário,1611.2848130649807,-4830,26442,31272
4,6ª a 9ª Fundamental,7633,Operadores De Máquinas Para Bordado E Acabamento De Roupas,1444.6945967341694,-864,3453,4317
4,6ª a 9ª Fundamental,7640,Trabalhadores Polivalentes Da Confecção De Calçados,1388.7100133025315,392,25611,25219
4,6ª a 9ª Fundamental,7641,Trabalhadores Da Preparação Da Confecção De Calçados,1517.024723771661,-654,13644,14298
4,6ª a 9ª Fundamental,7642,Operadores De Máquinas De Costurar E Montar Calçados,1771.3001897076829,-1260,6223,7483
4,6ª a 9ª Fundamental,7643,Trabalhadores De Acabamento De Calçados,1501.5942959377553,-479,4226,4705
4,6ª a 9ª Fundamental,7650,Trabalhadores Polivalentes Da Confecção De Artefatos De Tecidos E Couros,1267.2007762380053,17,251,234
4,6ª a 9ª Fundamental,7651,"Trabalhadores Da Preparação De Artefatos De Tecidos, Couros E Tapeçaria",1867.333146892056,-51,548,599
4,6ª a 9ª Fundamental,7652,"Trabalhadores Da Confecção De Artefatos De Tecidos, Couros E Sintéticos",1748.3045940194604,-314,2181,2495
4,6ª a 9ª Fundamental,7653,Operadores De Máquinas Na Confecção De Artefatos De  Couro,1490.353974784632,2,557,555
4,6ª a 9ª Fundamental,7654,Trabalhadores Do Acabamento De Artefatos De Tecidos E Couros,1403.8572035746358,22,807,785
4,6ª a 9ª Fundamental,7661,Trabalhadores Da Pré-Impressão Gráfica,2750.7479421946855,-86,241,327
4,6ª a 9ª Fundamental,7662,Trabalhadores Da Impressão Gráfica,2694.4234176583914,-497,1667,2164
4,6ª a 9ª Fundamental,7663,Trabalhadores Do Acabamento Gráfico,1926.873426118665,-310,1740,2050
4,6ª a 9ª Fundamental,7664,Trabalhadores De Laboratório Fotográfico E Radiológico,1583.7127552335223,-9,41,50
4,6ª a 9ª Fundamental,7681,"Trabalhadores De Tecelagem Manual, Tricô, Crochê, Rendas E Afins",1766.7784093308144,-44,154,198
4,6ª a 9ª Fundamental,7682,Trabalhadores Artesanais Da Confecção De Peças E Tecidos,1520.1227721414448,-35,86,121
4,6ª a 9ª Fundamental,7683,Trabalhadores Artesanais Da Confecção De Calçados E Artefatos De Couros E Peles,1532.23924415387,-95,2166,2261
4,6ª a 9ª Fundamental,7686,Trabalhadores Tipográficos Linotipistas E Afins,1846.4243284491897,-29,97,126
4,6ª a 9ª Fundamental,7687,Encadernadores E Recuperadores De Livros (Pequenos Lotes Ou A Unidade),1453.4353021240236,-10,21,31
4,6ª a 9ª Fundamental,7701,"Supervisores Em Indústria De Madeira, Mobiliário E Da Carpintaria Veicular",2828.280734703736,-184,768,952
4,6ª a 9ª Fundamental,7711,Marceneiros E Afins,1804.587084191853,-610,7181,7791
4,6ª a 9ª Fundamental,7721,Trabalhadores De Tratamento E Preparação Da Madeira,1541.7755967517096,126,4924,4798
4,6ª a 9ª Fundamental,7731,Operadores De Máquinas De Desdobramento Da Madeira,1955.4819393075043,-688,6486,7174
4,6ª a 9ª Fundamental,7732,Operadores De Máquinas De Aglomeração E Prensagem De Chapas,1617.1926378626522,-35,417,452
4,6ª a 9ª Fundamental,7733,Operadores De Usinagem Convencional De Madeira,2358.226246331949,-579,3901,4480
4,6ª a 9ª Fundamental,7734,Operadores De Máquina De Usinar Madeira (Produção Em Série),2393.5500281426043,-153,1012,1165
4,6ª a 9ª Fundamental,7735,Operadores De Máquinas De Usinagem De Madeira Cnc,1693.0327231131887,-97,186,283
4,6ª a 9ª Fundamental,7741,Montadores De Móveis E Artefatos De Madeira,1684.2766039508415,-750,5885,6635
4,6ª a 9ª Fundamental,7751,Trabalhadores De Arte E  Do Acabamento Em Madeira Do Mobiliário,1703.7916618784102,-91,727,818
4,6ª a 9ª Fundamental,7764,"Confeccionadores De Artefatos De Madeira, Móveis De Vime E Afins",1961.3883962750745,-36,177,213
4,6ª a 9ª Fundamental,7771,Carpinteiros Navais,2392.893158873484,-4,38,42
4,6ª a 9ª Fundamental,7772,Carpinteiros De Carrocerias E Carretas,1840.661858922192,-27,60,87
4,6ª a 9ª Fundamental,7801,Supervisores De Trabalhadores De Embalagem E Etiquetagem,2680.8228647399646,-100,189,289
4,6ª a 9ª Fundamental,7811,Condutores De Processos Robotizados,1879.306080750745,-16,43,59
4,6ª a 9ª Fundamental,7813,Operadores De Equipamentos Pilotados Remotamente,2111.989874002208,0,14,14
4,6ª a 9ª Fundamental,7817,Trabalhadores Subaquáticos,1961.6079938616072,3,19,16
4,6ª a 9ª Fundamental,7821,Operadores De Máquinas E Equipamentos De Elevação,3002.2707277083446,-317,6106,6423
4,6ª a 9ª Fundamental,7822,Operadores De Equipamentos De Movimentação De Cargas,2494.4426606476723,-2337,8327,10664
4,6ª a 9ª Fundamental,7823,Motoristas De Veículos De Pequeno E Médio Porte,1930.733494477783,-3949,24202,28151
4,6ª a 9ª Fundamental,7824,"Motoristas De Ônibus Urbanos, Metropolitanos E Rodoviários",2503.182591023978,-9896,21548,31444
4,6ª a 9ª Fundamental,7825,Motoristas De Veículos De Cargas Em Geral,3156.6757384498846,-1007,145036,146043
4,6ª a 9ª Fundamental,7826,Operadores De Veículos Sobre Trilhos E Cabos Aéreos,1854.9933159777447,-8,70,78
4,6ª a 9ª Fundamental,7827,Trabalhadores Aquaviários,2746.332034813957,-116,959,1075
4,6ª a 9ª Fundamental,7828,Condutores De Animais E De Veículos De Tração Animal E Pedais,1971.5505653601583,-23,327,350
4,6ª a 9ª Fundamental,7831,Trabalhadores De Manobras De Transportes Sobre Trilhos,2207.973640674895,-100,873,973
4,6ª a 9ª Fundamental,7832,Trabalhadores De Cargas E Descargas De Mercadorias,1704.6875777801988,1186,98677,97491
4,6ª a 9ª Fundamental,7841,Trabalhadores De Embalagem E De Etiquetagem,1608.8939192229561,463,37499,37036
4,6ª a 9ª Fundamental,7842,Alimentadores De Linhas De Produção,1993.7405959300297,22903,252948,230045
4,6ª a 9ª Fundamental,7911,Artesãos,1362.894398375479,15,124,109
4,6ª a 9ª Fundamental,8101,"Supervisores De Produção Em Indústrias Químicas, Petroquímicas E Afins",3378.1108078387606,-67,45,112
4,6ª a 9ª Fundamental,8102,Supervisores De Produção Em Indústrias De Transformação De Plásticos E Borrachas,4871.406986521251,-112,78,190
4,6ª a 9ª Fundamental,8103,"Supervisores De Produção Em Indústrias De Produtos Farmacêuticos, Cosméticos E Afins",3437.9605373806426,-4,7,11
4,6ª a 9ª Fundamental,8110,"Operadores Polivalentes De Equipamentos Em Indústrias Químicas, Petroquímicas E Afins",2681.3029261300344,-45,89,134
4,6ª a 9ª Fundamental,8111,Operadores De Equipamentos De Moagem E Mistura De Materiais (Tratamentos Químicos E Afins),1751.2395343106252,-90,922,1012
4,6ª a 9ª Fundamental,8112,Operadores De Calcinação E De Tratamentos Químicos De Materiais Radioativos,1433.1854241132016,3,169,166
4,6ª a 9ª Fundamental,8113,Operadores De Equipamentos De Filtragem E Separação,3014.3616026296036,-58,227,285
4,6ª a 9ª Fundamental,8114,"Operadores De Equipamentos De Destilação, Evaporação E Reação",6719.869345480383,-135,401,536
4,6ª a 9ª Fundamental,8115,Operadores De Equipamentos De Produção E Refino De Petróleo E Gás,1657.3706712598923,-7,9,16
4,6ª a 9ª Fundamental,8116,Operadores De Equipamentos De Coqueificação,1818.815161648885,-48,190,238
4,6ª a 9ª Fundamental,8117,"Operadores De Instalações E Máquinas De Produtos Plásticos, De Borracha E Moldadores De Parafinas",2027.2917174787763,-898,8743,9641
4,6ª a 9ª Fundamental,8118,"Operadores De Máquinas E Instalações De Produtos Farmacêuticos, Cosméticos E Afins",1767.5170051601312,-202,368,570
4,6ª a 9ª Fundamental,8121,Trabalhadores Da Fabricação De Munição E Explosivos Químicos,1357.6715405488474,-19,492,511
4,6ª a 9ª Fundamental,8131,"Operadores De Processos Das Indústrias De Transformação De Produtos Químicos, Petroquímicos E Afins",1810.1912540173007,-341,2619,2960
4,6ª a 9ª Fundamental,8181,Laboratoristas Industriais Auxiliares,6162.936079245197,-38,673,711
4,6ª a 9ª Fundamental,8201,Supervisores De Produção Em Indústrias Siderúrgicas,2849.4091683502857,-20,55,75
4,6ª a 9ª Fundamental,8202,Supervisores Na Fabricação De Materiais Para Construção (Vidros E Cerâmicas),3989.950740588551,-63,171,234
4,6ª a 9ª Fundamental,8211,Operadores De Instalações De Sinterização,1625.8181513549825,-24,63,87
4,6ª a 9ª Fundamental,8212,Operadores De Fornos De Primeira  Fusão E Aciaria,2025.9621532748104,-166,2086,2252
4,6ª a 9ª Fundamental,8213,Operadores De Equipamentos De Laminação,2859.4464726040246,-134,570,704
4,6ª a 9ª Fundamental,8214,Operadores De Equipamentos De Acabamento De Chapas E Metais,2202.445816937838,268,6723,6455
4,6ª a 9ª Fundamental,8221,Forneiros Metalúrgicos (Segunda Fusão E Reaquecimento),1758.5024525509912,-64,320,384
4,6ª a 9ª Fundamental,8231,"Operadores Na Preparação De Massas Para Abrasivo, Vidro, Cerâmica, Porcelana E Materiais De Construção",1914.4487044918883,-106,296,402
4,6ª a 9ª Fundamental,8232,"Operadores De Equipamentos De Fabricação  E Beneficiamento De Cristais, Vidros, Cerâmicas, Porcelanas, Fibras De Vidro, Abrasivos E Afins",1978.3597436269672,-82,481,563
4,6ª a 9ª Fundamental,8233,Operadores De Instalações E Equipamentos De Fabricação De Materiais De Construção,1622.1473073068014,191,7305,7114
4,6ª a 9ª Fundamental,8281,Trabalhadores Da Fabricação De Cerâmica Estrutural Para Construção,2253.3209968446836,-181,9048,9229
4,6ª a 9ª Fundamental,8301,Supervisores Da Fabricação De Celulose E Papel,4225.100097020467,-29,35,64
4,6ª a 9ª Fundamental,8311,Preparadores De Pasta Para Fabricação De Papel,2518.8824146822194,-45,113,158
4,6ª a 9ª Fundamental,8321,Operadores De Máquinas De Fabricar Papel E Papelão,1710.1306888361405,-268,784,1052
4,6ª a 9ª Fundamental,8331,Operadores De Máquinas Na Fabricação De Produtos De Papel E Papelão,1555.4745831924554,-136,1102,1238
4,6ª a 9ª Fundamental,8332,Trabalhadores Artesanais De Produtos De Papel E Papelão,1476.9122965014672,31,524,493
4,6ª a 9ª Fundamental,8401,"Supervisores Da Fabricação De Alimentos, Bebidas E Fumo",2600.0872400769836,-353,359,712
4,6ª a 9ª Fundamental,8411,"Trabalhadores Da Indústria De Beneficiamento De Grãos, Cereais E Afins",1862.0287303143293,-120,1798,1918
4,6ª a 9ª Fundamental,8412,Trabalhadores No Beneficiamento Do Sal,895.917343878398,101,503,402
4,6ª a 9ª Fundamental,8413,Trabalhadores Na Fabricação E Refino De Açúcar,9313.490163465849,-64,1466,1530
4,6ª a 9ª Fundamental,8414,Trabalhadores Na Fabricação E Conservação De Alimentos,1501.420946239709,-915,10759,11674
4,6ª a 9ª Fundamental,8415,Trabalhadores Na Pasteurização Do Leite E Na Fabricação De Laticínios  E Afins,1451.946642399999,-129,4033,4162
4,6ª a 9ª Fundamental,8416,"Trabalhadores Na Industrialização De Café, Cacau, Mate E De Produtos Afins",1776.0523021617782,-43,145,188
4,6ª a 9ª Fundamental,8417,"Trabalhadores Na Fabricação De Cachaça, Cerveja, Vinhos E Outras Bebidas",2219.2637043099307,-2,1186,1188
4,6ª a 9ª Fundamental,8418,"Operadores De Equipamentos Na Fabricação De Pães, Massas Alimentícias, Doces, Chocolates E Achocolatados",1577.8983125457169,-911,3999,4910
4,6ª a 9ª Fundamental,8421,Cigarreiros E Beneficiadores De Fumo,1414.2506119635173,1220,15881,14661
4,6ª a 9ª Fundamental,8422,Charuteiros,1824.692874000186,0,11,11
4,6ª a 9ª Fundamental,8481,Trabalhadores Artesanais Na Conservação De Alimentos,1739.0800589272396,-186,1538,1724
4,6ª a 9ª Fundamental,8482,Trabalhadores Artesanais Na Pasteurização Do Leite E Na Fabricação De Laticínios E Afins,1514.1549343571503,-151,431,582
4,6ª a 9ª Fundamental,8483,"Padeiros, Confeiteiros E Afins",1735.1280661924109,-2636,12281,14917
4,6ª a 9ª Fundamental,8484,Trabalhadores Na Degustação E Classificação De Grãos E Afins,1154.649361155965,-141,711,852
4,6ª a 9ª Fundamental,8485,Magarefes E Afins,1601.3308525752168,4563,103945,99382
4,6ª a 9ª Fundamental,8486,Trabalhadores Artesanais Na Indústria Do Fumo,1420.2441714956221,61,2280,2219
4,6ª a 9ª Fundamental,8601,Supervisores Da Produção De Utilidades,2974.983053963577,-126,216,342
4,6ª a 9ª Fundamental,8611,"Operadores De Instalações De Geração E Distribuição De Energia Elétrica, Hidráulica, Térmica Ou Nuclear",3885.500202862678,-55,111,166
4,6ª a 9ª Fundamental,8612,Operadores De Instalações De Distribuição De Energia Elétrica,1944.4922761462983,-52,58,110
4,6ª a 9ª Fundamental,8621,Operadores De Máquinas A Vapor E Utilidades,4306.665880547913,-2856,14255,17111
4,6ª a 9ª Fundamental,8622,"Operadores De Instalações De Captação, Tratamento E Distribuição De Água",4516.163443964057,-68,539,607
4,6ª a 9ª Fundamental,8623,Operadores De Instalações De Captação E Esgotos,1630.7655355688244,87,1279,1192
4,6ª a 9ª Fundamental,8624,"Operadores De Instalações De Extração, Processamento, Envasamento E Distribuição De Gases",1618.2009996686663,-44,48,92
4,6ª a 9ª Fundamental,8625,Operadores De Instalações De Refrigeração E Ar-Condicionado,2627.097833631787,-58,216,274
4,6ª a 9ª Fundamental,9101,"Supervisores Em Serviços De Reparação E Manutenção De Máquinas E Equipamentos Industriais, Comerciais E Residenciais",11109.159830531178,-296,787,1083
4,6ª a 9ª Fundamental,9102,Supervisores Em Serviços De Reparação E Manutenção Veicular,2914.4829140496745,-126,190,316
4,6ª a 9ª Fundamental,9109,"Supervisores De Outros Trabalhadores De Serviços De Reparação, Conservação E Manutenção",2729.957827496156,21,94,73
4,6ª a 9ª Fundamental,9111,"Mecânicos De Manutenção De Bombas, Motores, Compressores E Equipamentos De Transmissão",2204.4614907629702,-129,1689,1818
4,6ª a 9ª Fundamental,9112,Mecânicos De Manutenção E Instalação De Aparelhos De  Climatização E Refrigeração,1735.3744498155716,-97,1527,1624
4,6ª a 9ª Fundamental,9113,Mecânicos De Manutenção De Máquinas Industriais,3786.359505004328,-443,14501,14944
4,6ª a 9ª Fundamental,9131,Mecânicos De Manutenção De Máquinas Pesadas E Equipamentos Agrícolas,3256.73891127989,43,4778,4735
4,6ª a 9ª Fundamental,9141,Mecânicos De Manutenção Aeronáutica,1903.575599615719,-28,119,147
4,6ª a 9ª Fundamental,9142,Mecânicos De Manutenção De Motores E Equipamentos Navais,2261.0473461151123,2,33,31
4,6ª a 9ª Fundamental,9143,Mecânicos De Manutenção Metroferroviária,5869.518463201837,-72,192,264
4,6ª a 9ª Fundamental,9144,Mecânicos De Manutenção De Veículos Automotores,2737.218531970665,-1442,19628,21070
4,6ª a 9ª Fundamental,9151,Técnicos Em Manutenção E Reparação De Instrumentos De Medição E Precisão,1955.126386525311,-1,94,95
4,6ª a 9ª Fundamental,9152,Restauradores De Instrumentos Musicais,1960.8099975585938,-2,0,2
4,6ª a 9ª Fundamental,9153,Técnicos Em Manutenção E Reparação De Equipamentos Biomédicos,1905.5513305664063,0,15,15
4,6ª a 9ª Fundamental,9154,Reparadores De Equipamentos Fotográficos,628.5,0,1,1
4,6ª a 9ª Fundamental,9191,Lubrificadores,1818.483031796035,-425,2522,2947
4,6ª a 9ª Fundamental,9192,"Trabalhadores De Manutenção De Roçadeiras, Motoserras E Similares",1881.6117960034785,-210,1412,1622
4,6ª a 9ª Fundamental,9193,Mecânicos De Manutenção De Bicicletas E Equipamentos Esportivos E De Ginástica,1692.3403529179184,-38,619,657
4,6ª a 9ª Fundamental,9501,"Supervisores De Manutenção Eletroeletrônica Industrial, Comercial E Predial",5894.863572642134,-214,560,774
4,6ª a 9ª Fundamental,9502,Supervisores De Manutenção Eletroeletrônica Veicular,2909.192636165979,-18,44,62
4,6ª a 9ª Fundamental,9503,Supervisores De Manutenção Eletromecânica,4583.392404740856,-30,78,108
4,6ª a 9ª Fundamental,9511,Eletricistas De Manutenção Eletroeletrônica,2414.691502344498,-616,4407,5023
4,6ª a 9ª Fundamental,9513,Instaladores E Mantenedores De Sistemas Eletroeletrônicos De Segurança,1651.4082955122958,-50,923,973
4,6ª a 9ª Fundamental,9531,"Eletricistas Eletrônicos De Manutenção Veicular (Aérea, Terrestre E Naval)",2610.5747974588808,-239,1846,2085
4,6ª a 9ª Fundamental,9541,"Instaladores E Mantenedores Eletromecânicos De Elevadores, Escadas E Portas Automáticas",2049.3176154085977,-57,895,952
4,6ª a 9ª Fundamental,9542,Reparadores De Aparelhos Eletrodomésticos,1457.8745151348967,-18,67,85
4,6ª a 9ª Fundamental,9543,Reparadores De Equipamentos De Escritório,1544.6690521240234,-2,15,17
4,6ª a 9ª Fundamental,9911,Conservadores De Vias Permanentes (Trilhos),1993.240620180307,476,3183,2707
4,6ª a 9ª Fundamental,9912,Mantenedores De Equipamentos De Parques De Diversões E Similares,1423.130911778922,-16,91,107
4,6ª a 9ª Fundamental,9913,Reparadores De Carrocerias De Veículos,1896.4211313993626,-496,3066,3562
4,6ª a 9ª Fundamental,9921,Trabalhadores Elementares De Serviços De Manutenção Veicular,1789.9709821542638,-329,6186,6515
4,6ª a 9ª Fundamental,9922,Trabalhadores Operacionais De Conservação De Vias Permanentes (Exceto Trilhos),2046.9060039321812,589,23629,23040
5,Fundamental Completo,0000,Não especificado,3487.714286455352,513,919,406
5,Fundamental Completo,0101,Oficiais Generais Das Forças Armadas,2137.342226300921,20,152,132
5,Fundamental Completo,0102,Oficiais Das Forças Armadas,1617.458695281498,10,30,20
5,Fundamental Completo,0103,Praças Das Forças Armadas,1631.6698636065473,9,24,15
5,Fundamental Completo,0201,Oficiais Superiores Da Polícia Militar,1910.8087615966797,-1,2,3
5,Fundamental Completo,0202,Capitães Da  Polícia Militar,3725,1,1,0
5,Fundamental Completo,0203,Tenentes Da Polícia Militar,1540.5800170898438,2,2,0
5,Fundamental Completo,0211,Subtenentes E Sargentos Da Policia Militar,1446.818344116211,9,14,5
5,Fundamental Completo,0212,Cabos E Soldados Da Polícia Militar,2473.4000651041665,1,2,1
5,Fundamental Completo,0301,Oficiais Superiores Do Corpo De Bombeiros Militar,1252.5,2,7,5
5,Fundamental Completo,0311,Subtenentes E Sargentos Do Corpo De Bombeiros Militar,1050,-1,0,1
5,Fundamental Completo,1111,Legisladores,1553.7262594108909,3,60,57
5,Fundamental Completo,1112,Dirigentes Gerais Da Administração Pública,1553.1045905480019,28,117,89
5,Fundamental Completo,1113,Magistrados,1686,1,2,1
5,Fundamental Completo,1114,Dirigentes Do Serviço Público,2290.1397890850485,126,324,198
5,Fundamental Completo,1115,Gestores Públicos,3550.1114844345466,-5,18,23
5,Fundamental Completo,1130,"Dirigentes De Povos Indígenas, De Quilombolas E Caiçaras",3147.8333333333335,-1,1,2
5,Fundamental Completo,1141,Dirigentes De Partidos Políticos,2776.9549560546875,0,1,1
5,Fundamental Completo,1142,Dirigentes E Administradores De Entidades Patronais E Dos Trabalhadores E De Outros Interesses Sócioeconômicos,2689.119637625558,-25,12,37
5,Fundamental Completo,1143,Dirigentes E Administradores De Entidades Religiosas,1585,1,1,0
5,Fundamental Completo,1144,Dirigentes E Administradores De Organizações Da Sociedade Civil Sem Fins Lucrativos,1670.771240234375,4,6,2
5,Fundamental Completo,1210,Diretores Gerais,2193.963959142141,-95,440,535
5,Fundamental Completo,1221,"Diretores De Produção E Operações Em Empresa Agropecuária, Pesqueira , Aqüícola E Florestal",1886.5148644927747,-5,27,32
5,Fundamental Completo,1222,"Diretores De Produção E Operações Em Empresa Da Indústria Extrativa, Transformação E De Serviços De Utilidade Pública",2595.9896712764616,-5,13,18
5,Fundamental Completo,1223,Diretores De Operações De Obras Em Empresa De Construção,2757.1177775065103,1,28,27
5,Fundamental Completo,1224,Diretores De Operações Em Empresa Do Comércio,2488.037847780714,-2,25,27
5,Fundamental Completo,1225,"Diretores De Serviços De Turismo, De Alojamento E De Alimentação",2093.749801437254,4,46,42
5,Fundamental Completo,1226,"Diretores De Operações De Serviços Em Empresa De Armazenamento, De Transporte E De Telecomunicação",2189.694444117258,-11,20,31
5,Fundamental Completo,1227,Diretores De Operações De Serviços Em Instituição De Intermediação Financeira,6469.69926961263,-3,2,5
5,Fundamental Completo,1231,Diretores Administrativos E Financeiros,2521.57736506419,-140,524,664
5,Fundamental Completo,1232,Diretores De Recursos Humanos E Relações De Trabalho,2298.453123869719,6,18,12
5,Fundamental Completo,1233,Diretores De Comercialização E Marketing,3614.4779123659487,-13,71,84
5,Fundamental Completo,1234,Diretores De Suprimentos E Afins,2551.5705017089845,-3,4,7
5,Fundamental Completo,1236,Diretores De Tecnologia Da Informação,5967.432264539931,-1,4,5
5,Fundamental Completo,1237,Diretores De Pesquisa E Desenvolvimento,8922.725036621094,-4,0,4
5,Fundamental Completo,1238,Diretores De Manutenção,2643.0196629213483,-15,37,52
5,Fundamental Completo,1311,"Diretores E Gerentes De Operações Em Empresa De Serviços Pessoais, Sociais E Culturais",3062.4985199559696,-39,126,165
5,Fundamental Completo,1312,"Gestores E Especialistas De Operações Em Empresas, Secretarias E Unidades De Serviços De Saúde",2096.6431787664237,-10,97,107
5,Fundamental Completo,1313,Diretores E Gerentes De Instituição De Serviços Educacionais,2415.4237995877293,-48,83,131
5,Fundamental Completo,1411,"Gerentes De Produção E Operações Em Empresa Agropecuária, Pesqueira, Aqüícola E Florestal",2618.2454130679525,-134,1401,1535
5,Fundamental Completo,1412,"Gerentes De Produção E Operações Em Empresa Da Indústria Extrativa, De Transformação E De Serviços De Utilidade Pública",3413.323079989901,-814,2849,3663
5,Fundamental Completo,1413,Gerentes De Obras Em Empresa De Construção,4041.606023582382,-122,536,658
5,Fundamental Completo,1414,Gerentes De Operações Comerciais E De Assistência Técnica,2150.073114650113,-3070,9177,12247
5,Fundamental Completo,1415,"Gerentes De Operações De Serviços Em Empresa De Turismo, De Alojamento E Alimentação",2166.391703628039,-1547,2456,4003
5,Fundamental Completo,1416,"Gerentes De Operações De Serviços Em Empresa De Transporte, De Comunicação E De Logística (Armazenagem E Distribuição)",2570.6724250690554,-647,1015,1662
5,Fundamental Completo,1417,Gerentes De Operações De Serviços Em Instituição De Intermediação Financeira,3211.7683894704533,-20,64,84
5,Fundamental Completo,1418,Gerentes Operacionais Da Aviação Civil,3101.9036085340713,4,10,6
5,Fundamental Completo,1421,"Gerentes Administrativos, Financeiros, De Riscos E Afins",4360.555174562437,-2379,5484,7863
5,Fundamental Completo,1422,Gerentes De Recursos Humanos E De Relações Do Trabalho,2807.949038269513,-115,265,380
5,Fundamental Completo,1423,"Gerentes De Comercialização, Marketing E Comunicação",2682.458167965759,-2743,5105,7848
5,Fundamental Completo,1424,Gerentes De Suprimentos E Afins,3242.245176318606,-202,391,593
5,Fundamental Completo,1425,Gerentes De Tecnologia Da Informação,6567.3892422718645,-62,158,220
5,Fundamental Completo,1426,Gerentes De Pesquisa E Desenvolvimento E Afins,4882.828903198242,-14,25,39
5,Fundamental Completo,1427,Gerentes De Manutenção E Afins,2991.9529504135726,-178,336,514
5,Fundamental Completo,2011,Profissionais Da Biotecnologia,1631.0491739908853,-1,2,3
5,Fundamental Completo,2012,Profissionais Da Metrologia,2883.483744212559,-1,14,15
5,Fundamental Completo,2021,"Engenheiros De Controle E Automação, Engenheiros Mecatrônicos E Afins",4039.9430888493857,-5,26,31
5,Fundamental Completo,2030,Pesquisadores Das Ciências Biológicas,1934.743330891927,-5,7,12
5,Fundamental Completo,2031,Pesquisadores Das Ciências Naturais E Exatas,2468.358331298828,-1,5,6
5,Fundamental Completo,2032,Pesquisadores De Engenharia E Tecnologia,3898.1842545729414,3,12,9
5,Fundamental Completo,2033,Pesquisadores Das Ciências Da Saúde,2196.415069580078,-6,1,7
5,Fundamental Completo,2034,Pesquisadores Das Ciências Da Agricultura,2128.5649625491474,0,12,12
5,Fundamental Completo,2035,Pesquisadores Das Ciências Sociais E Humanas,1808.5757575757573,-4,5,9
5,Fundamental Completo,2041,Peritos Criminais E Judiciais,4788,-2,0,2
5,Fundamental Completo,2111,Profissionais Da Matemática,2189.10673380133,5,35,30
5,Fundamental Completo,2112,Profissionais De Estatística E Afins,3346.570841471354,-3,2,5
5,Fundamental Completo,2122,Engenheiros Em Computação,7478.330313449435,1,17,16
5,Fundamental Completo,2123,Administradores De Tecnologia Da Informação,3405.7545150074257,35,150,115
5,Fundamental Completo,2124,Analistas De Tecnologia Da Informação,4360.157917760399,69,1139,1070
5,Fundamental Completo,2131,Físicos,2160.57666015625,-1,2,3
5,Fundamental Completo,2132,Químicos,2350.598112135667,-18,36,54
5,Fundamental Completo,2133,Profissionais Das Ciências Atmosféricas E Espaciais E De Astronomia,1359.5999755859375,-1,0,1
5,Fundamental Completo,2134,"Geólogos, Oceanógrafos, Geofísicos E Afins",2760.5651414659287,-3,11,14
5,Fundamental Completo,2140,Engenheiros Ambientais E Afins,2717.1668445933947,13,65,52
5,Fundamental Completo,2141,Arquitetos E Urbanistas,2119.5147778084524,-25,62,87
5,Fundamental Completo,2142,Engenheiros Civis E Afins,3333.47593969075,19,319,300
5,Fundamental Completo,2143,"Engenheiros Eletricistas, Eletrônicos E Afins",3538.3008911292163,4,170,166
5,Fundamental Completo,2144,Engenheiros Mecânicos E Afins,6054.593675921103,8,92,84
5,Fundamental Completo,2145,Engenheiros Químicos E Afins,6378.1066487630205,-1,13,14
5,Fundamental Completo,2146,"Engenheiros Metalurgistas, De Materiais E Afins",8772.427832657251,-6,9,15
5,Fundamental Completo,2147,Engenheiros De Minas E Afins,1964.3133341471355,-3,0,3
5,Fundamental Completo,2148,Engenheiros Agrimensores E Engenheiros Cartógrafos,3886.0810302734376,-1,3,4
5,Fundamental Completo,2149,"Engenheiros De Produção, Qualidade, Segurança E Afins",3408.867492505159,16,181,165
5,Fundamental Completo,2151,Oficiais De Convés E Afins,2589.311248096892,-42,102,144
5,Fundamental Completo,2152,Oficiais De Máquinas Da Marinha Mercante,2806.086417125908,-19,49,68
5,Fundamental Completo,2153,Profissionais Da Pilotagem Aeronáutica,4156.636331554229,-8,53,61
5,Fundamental Completo,2211,Biólogos E Afins,2352.990664395419,2,23,21
5,Fundamental Completo,2212,Biomédicos,2362.4420855633625,5,41,36
5,Fundamental Completo,2221,Engenheiros Agrossilvipecuários,3693.890088733874,4,65,61
5,Fundamental Completo,2222,Engenheiros De Alimentos E Afins,875.8421859741211,-2,9,11
5,Fundamental Completo,2232,Cirurgiões-Dentistas,2591.3455609639486,-11,13,24
5,Fundamental Completo,2233,Veterinários E Zootecnistas,2553.717353690011,-11,42,53
5,Fundamental Completo,2234,Farmacêuticos,3400.2318760758967,-4,354,358
5,Fundamental Completo,2235,Enfermeiros E Afins,2559.0516269894497,-120,443,563
5,Fundamental Completo,2236,Fisioterapeutas,47929.35649812323,-6,129,135
5,Fundamental Completo,2237,Nutricionistas,3021.082144694845,10,504,494
5,Fundamental Completo,2238,Fonoaudiólogos,3230.7686390659264,2,36,34
5,Fundamental Completo,2239,"Terapeutas Ocupacionais, Ortoptistas E Psicomotricistas",2882.508079061703,5,29,24
5,Fundamental Completo,2241,Profissionais Da Educação Física,9425.689963671937,-128,540,668
5,Fundamental Completo,2251,Médicos Clínicos,4810.99984269727,-6,112,118
5,Fundamental Completo,2252,Médicos Em Especialidades Cirúrgicas,3055.9416673007986,-13,16,29
5,Fundamental Completo,2253,Médicos Em Medicina Diagnóstica E Terapêutica,2975.0999755859375,-2,0,2
5,Fundamental Completo,2263,"Profissionais Das Terapias Criativas,Equoterápicas E Naturológicas",1466.0333251953125,-4,1,5
5,Fundamental Completo,2311,Professores De Nível Superior Na Educação Infantil,2982.928306974629,-80,211,291
5,Fundamental Completo,2312,Professores De Nível Superior Do Ensino Fundamental (Primeira A Quarta Séries),3736.2216827930724,-212,379,591
5,Fundamental Completo,2313,Professores De Nível Superior No Ensino Fundamental De Quinta A Oitava Série,1982.0465632876658,-110,120,230
5,Fundamental Completo,2321,Professores Do Ensino Médio,1963.0101866360906,-142,144,286
5,Fundamental Completo,2331,Professores Do Ensino Profissional,1728.0724073231922,-19,13,32
5,Fundamental Completo,2332,Instrutores De Ensino Profissional,4539.866013058136,-192,360,552
5,Fundamental Completo,2341,"Professores De Matemática, Estatística E Informática Do Ensino Superior",895.740000406901,-1,1,2
5,Fundamental Completo,2342,"Professores De Ciências Físicas, Químicas E Afins Do Ensino Superior",800,-1,0,1
5,Fundamental Completo,2343,"Professores De Arquitetura E Urbanismo, Engenharia, Geofísica E Geologia Do Ensino Superior",2181.638193130493,-7,1,8
5,Fundamental Completo,2344,Professores De Ciências Biológicas E Da Saúde Do Ensino Superior,15654.84436744908,-6,41,47
5,Fundamental Completo,2345,Professores Na Área De Formação Pedagógica Do Ensino Superior,15488.185041205943,-179,35,214
5,Fundamental Completo,2346,Professores Nas Áreas De Língua E Literatura Do Ensino Superior,2053.0311829938723,-14,109,123
5,Fundamental Completo,2347,Professores De Ciências Humanas Do Ensino Superior,9960.305921645391,-8,7,15
5,Fundamental Completo,2348,"Professores De Ciências Econômicas, Administrativas E Contábeis Do Ensino Superior",2042.8761957524368,6,30,24
5,Fundamental Completo,2349,Professores De Artes Do Ensino Superior,3036.221692911784,-5,6,11
5,Fundamental Completo,2392,Professores De Educação Especial,2810.345764224531,-15,49,64
5,Fundamental Completo,2394,"Programadores, Avaliadores E Orientadores De Ensino",2384.189669695577,-145,529,674
5,Fundamental Completo,2410,Advogados,2255.7715105003635,-12,134,146
5,Fundamental Completo,2413,Tabeliães E Registradores,1707.8392216072677,42,184,142
5,Fundamental Completo,2423,Delegados De Polícia,2894.06005859375,-1,0,1
5,Fundamental Completo,2424,Defensores Públicos E Procuradores Da Assistência Judiciária,1356.9500122070313,0,2,2
5,Fundamental Completo,2511,Profissionais Em Pesquisa E Análise Antropológica Sociológica,1386.4338088262648,-2,4,6
5,Fundamental Completo,2512,Economistas,2774.9872057317066,-4,99,103
5,Fundamental Completo,2513,Profissionais Em Pesquisa E Análise Geográfica,2972.52001953125,-1,0,1
5,Fundamental Completo,2514,Filósofos,0,-1,0,1
5,Fundamental Completo,2515,Psicólogos E Psicanalistas,2233.834939053097,-9,79,88
5,Fundamental Completo,2516,Assistentes Sociais E Economistas Domésticos,1718.2994261169433,23,113,90
5,Fundamental Completo,2521,Administradores,3242.9141521977886,-118,1729,1847
5,Fundamental Completo,2522,Contadores E Afins,2331.5738489593073,-134,438,572
5,Fundamental Completo,2523,Secretárias(Os) Executivas(Os) E Afins,1636.24963919312,-252,2363,2615
5,Fundamental Completo,2524,Profissionais De Recursos Humanos,2550.9424007208363,36,487,451
5,Fundamental Completo,2525,Profissionais De Administração Ecônomico-Financeira,2580.362278651493,-47,401,448
5,Fundamental Completo,2526,Profissionais Da Administração Dos Serviços De Segurança,2464.3612245501895,-8,29,37
5,Fundamental Completo,2527,"Profissionais De Planejamento, Programação E Controles Logisticos",2891.6235117465,7,254,247
5,Fundamental Completo,2531,Profissionais De Publicidade,5941.202100195072,65,466,401
5,Fundamental Completo,2532,Profissionais De Comercializacão E Consultoria De Serviços Bancários,2612.929257898749,-20,598,618
5,Fundamental Completo,2533,"Corretores De Valores, Ativos Financeiros, Mercadorias E Derivativos",1642.5118303800884,-4,36,40
5,Fundamental Completo,2534,Profissionais De Mídias Digitais E Afins,1939.8399237217045,34,85,51
5,Fundamental Completo,2541,Auditores Fiscais E Técnicos Da Receita Federal,1488.624982561384,3,6,3
5,Fundamental Completo,2543,Auditores Fiscais Do Trabalho,1620.6967933660148,293,1888,1595
5,Fundamental Completo,2544,Fiscais De Tributos Estaduais E Municipais,1305.60916679019,-13,18,31
5,Fundamental Completo,2545,Profissionais Da Fiscalização De Atividades Urbanas,1543.032984147992,18,123,105
5,Fundamental Completo,2611,Profissionais Do Jornalismo,2971.2929038012803,-83,262,345
5,Fundamental Completo,2612,Profissionais Da Informação,2145.842892210057,6,87,81
5,Fundamental Completo,2613,Arquivistas E Museólogos,1647.5764523080536,-17,88,105
5,Fundamental Completo,2614,"Filólogos,Tradutores ,Intérpretes E Afins",2056.839121859801,-6,35,41
5,Fundamental Completo,2615,Profissionais Da Escrita,1820.8244805908203,-5,16,21
5,Fundamental Completo,2616,Editores,2107.0499627249583,-4,13,17
5,Fundamental Completo,2617,"Locutores, Comentaristas E Repórteres De Mídias Audiovisuais",1779.7831969842423,-121,395,516
5,Fundamental Completo,2618,Fotógrafos Profissionais,1916.9205302301184,-41,153,194
5,Fundamental Completo,2619,Assistentes De Direção (Tv) E Continuístas,1492.7349853515625,4,8,4
5,Fundamental Completo,2621,Produtores Artísticos E Culturais,2366.932958726583,-17,61,78
5,Fundamental Completo,2622,Diretores De Espetáculos E Afins,2154.502166444969,-12,16,28
5,Fundamental Completo,2623,Cenógrafos,1744.9920225016278,7,38,31
5,Fundamental Completo,2624,"Artistas Visuais,Desenhistas Industriais E Conservadores-Restauradores De Bens Culturais",2923.702041184361,126,848,722
5,Fundamental Completo,2625,Atores,3878.6343074374727,-18,27,45
5,Fundamental Completo,2626,"Músicos Compositores, Arranjadores, Regentes E Musicólogos",1221.1114989728908,-6,33,39
5,Fundamental Completo,2627,Músicos Intérpretes,1750.8172916219658,-20,87,107
5,Fundamental Completo,2628,Artistas Da Dança (Exceto Dança Tradicional E Popular),1633.5537954259803,-20,46,66
5,Fundamental Completo,2629,Designer De Interiores De Nível Superior,2202.183847280649,-3,5,8
5,Fundamental Completo,2631,"Ministros De Culto, Missionários, Teólogos E Profissionais Assemelhados",1605.639926474237,-21,43,64
5,Fundamental Completo,2711,Chefes De Cozinha E Afins,1970.4840501662288,-790,1840,2630
5,Fundamental Completo,3001,Técnicos Em Mecatrônica,2380.1709787740338,19,131,112
5,Fundamental Completo,3003,Técnicos Em Eletromecânica,2263.928633474576,123,799,676
5,Fundamental Completo,3011,Técnicos De Laboratório Industrial,2649.8025095290127,-20,2352,2372
5,Fundamental Completo,3012,Técnicos De Apoio À Bioengenharia,2459.3395783797555,13,18,5
5,Fundamental Completo,3111,Técnicos Químicos,3611.3386174417647,-98,261,359
5,Fundamental Completo,3112,"Técnicos De Produção De Indústrias Químicas, Petroquímicas, Refino De Petróleo, Gás E Afins",2722.369481136924,-9,5,14
5,Fundamental Completo,3113,"Técnicos Em Materiais, Produtos Cerâmicos E Vidros",20813.243932885638,-17,21,38
5,Fundamental Completo,3114,Técnicos Em Fabricação De Produtos Plásticos E De Borracha,1804.0128255802229,-86,530,616
5,Fundamental Completo,3115,"Técnicos Em Controle Ambiental, Utilidades E Tratamento De Efluentes",3713.4218254239127,-70,309,379
5,Fundamental Completo,3116,Técnicos Têxteis,2557.415270817043,-18,54,72
5,Fundamental Completo,3117,Coloristas,3393.821247537652,-167,4404,4571
5,Fundamental Completo,3121,Técnicos Em Construção Civil (Edificações),2999.8281786886378,90,1633,1543
5,Fundamental Completo,3122,Técnicos Em Construção Civil (Obras De Infraestrutura),2854.766133192802,2,643,641
5,Fundamental Completo,3123,Técnicos Em Geomática,2197.3409592497896,-4,4832,4836
5,Fundamental Completo,3131,Técnicos Em Eletricidade E Eletrotécnica,2842.4495369043,-629,4508,5137
5,Fundamental Completo,3132,Técnicos Em Eletrônica,2310.2623266232895,-405,3447,3852
5,Fundamental Completo,3133,Técnicos Em Telecomunicações,1576.3822329922266,60,2598,2538
5,Fundamental Completo,3134,Técnicos Em Calibração E Instrumentação,3618.097965689891,-211,1123,1334
5,Fundamental Completo,3135,Técnicos Em Fotônica,1552.165415181993,-20,385,405
5,Fundamental Completo,3141,"Técnicos Mecânicos Na Fabricação E Montagem De Máquinas, Sistemas E Instrumentos",3333.3762201604477,-59,3768,3827
5,Fundamental Completo,3142,Técnicos Mecânicos (Ferramentas),3315.9973770463694,-47,197,244
5,Fundamental Completo,3143,Técnicos Em Mecânica Veicular,2560.905034942028,13,273,260
5,Fundamental Completo,3144,"Técnicos Mecânicos Na Manutenção De Máquinas, Sistemas E Instrumentos",12170.873487131055,-76,1179,1255
5,Fundamental Completo,3146,Técnicos Em Metalurgia (Estruturas Metálicas),4570.543992531274,-60,385,445
5,Fundamental Completo,3147,Técnicos Em Siderurgia,3231.3994314294305,3,88,85
5,Fundamental Completo,3148,Especialistas Em Inspeções Industriais,4272.565138390533,1,75,74
5,Fundamental Completo,3161,Técnicos Em Geologia,2603.43744648207,32,119,87
5,Fundamental Completo,3163,Técnicos Em Mineração,2743.9459636786964,6,72,66
5,Fundamental Completo,3171,Técnicos De Desenvolvimento De Sistemas E Aplicações,2686.961345865022,32,615,583
5,Fundamental Completo,3172,Técnicos De Suporte E Monitoração Ao Usuário De Tecnologia Da Informação.,1612.7656685972759,32,1602,1570
5,Fundamental Completo,3180,"Desenhistas Técnicos, Em Geral",2300.6962263502423,-57,169,226
5,Fundamental Completo,3181,Desenhistas Técnicos Da Construção Civil E Arquitetura,2043.2526335136472,-19,103,122
5,Fundamental Completo,3182,Desenhistas Técnicos Da Mecânica,2007.4400179073727,28,160,132
5,Fundamental Completo,3183,"Desenhistas Técnicos Em Eletricidade, Eletrônica, Eletromecânica, Calefação, Ventilação E Refrigeração",1610.5318192059722,-23,31,54
5,Fundamental Completo,3184,Desenhistas Técnicos De Produtos E Serviços Diversos,1917.005311208806,-46,251,297
5,Fundamental Completo,3185,Desenhistas Projetistas De Construção Civil E Arquitetura,3949.607835983021,31,253,222
5,Fundamental Completo,3186,Desenhistas Projetistas Da Mecânica,4858.120327301414,-11,152,163
5,Fundamental Completo,3187,Desenhistas Projetistas Da Eletrônica,2372.6533039052,-5,46,51
5,Fundamental Completo,3188,Desenhistas Projetistas E Modelistas De Produtos E Serviços Diversos,2858.304148515821,-162,528,690
5,Fundamental Completo,3191,Técnicos Do Vestuário,2650.287118751415,-14,27,41
5,Fundamental Completo,3192,Técnicos Do Mobiliário E Afins,1783.2809744113829,-6,38,44
5,Fundamental Completo,3201,Técnicos Em Biologia,1405.8242510516827,7,29,22
5,Fundamental Completo,3211,Técnicos Agrícolas,4040.9341754352954,-193,670,863
5,Fundamental Completo,3212,Técnicos Florestais,1546.309626199243,88,713,625
5,Fundamental Completo,3213,Técnicos Em Aqüicultura,2292.9269631666516,13,45,32
5,Fundamental Completo,3221,Tecnólogos E Técnicos Em Terapias Complementares E Estéticas,1573.0500092483976,-194,412,606
5,Fundamental Completo,3222,Técnicos E Auxiliares De Enfermagem,1915.2341131791813,-2170,4196,6366
5,Fundamental Completo,3223,Técnicos Em Óptica E Optometria,1613.6757755985966,-15,60,75
5,Fundamental Completo,3224,Técnicos De Odontologia,1556.0106644205555,-323,1933,2256
5,Fundamental Completo,3225,Técnicos Em Próteses Ortopédicas,2289.899423452524,-14,19,33
5,Fundamental Completo,3226,Técnicos De Imobilizações Ortopédicas,1968.6436742665817,-17,16,33
5,Fundamental Completo,3231,Técnicos Em Pecuária,1602.1153530710112,203,409,206
5,Fundamental Completo,3241,Tecnólogos E Técnicos Em Métodos De Diagnósticos E Terapêutica,2072.75587363155,-106,130,236
5,Fundamental Completo,3242,Técnicos De Laboratórios De Saúde E Bancos De Sangue,2623.467260771774,-150,176,326
5,Fundamental Completo,3250,"Enólogos, Perfumistas E Aromistas",2251.7324412300254,12,147,135
5,Fundamental Completo,3251,Técnico Em Farmácia E Em Manipulação Farmacêutica,1747.3843470336317,-67,273,340
5,Fundamental Completo,3252,"Técnicos Em Produção, Conservação  E De Qualidade De Alimentos",1766.666748415153,-321,793,1114
5,Fundamental Completo,3253,Técnicos De Apoio À Biotecnologia,1516.88798828125,1,3,2
5,Fundamental Completo,3281,Técnicos Em Necrópsia E Taxidermistas,1680.1199951171875,2,7,5
5,Fundamental Completo,3311,Professores De Nível Médio Na Educação Infantil,2752.173290683861,-416,2964,3380
5,Fundamental Completo,3312,Professores De Nível Médio No Ensino Fundamental,1598.4261744999303,-113,176,289
5,Fundamental Completo,3313,Professores De Nível Médio No Ensino Profissionalizante,1316.57224904711,-1,61,62
5,Fundamental Completo,3321,Professores Leigos No Ensino Fundamental,1354.7228411375172,-29,54,83
5,Fundamental Completo,3322,Professores Práticos No Ensino Profissionalizante,1637.2557567249644,-13,10,23
5,Fundamental Completo,3331,Instrutores E Professores De Cursos Livres,2343.9386839973167,-381,1829,2210
5,Fundamental Completo,3341,Inspetores De Alunos E Afins,1508.0512797030078,678,7406,6728
5,Fundamental Completo,3411,"Pilotos De Aviação Comercial, Mecânicos De Vôo E Afins",3786.0767209075607,14,67,53
5,Fundamental Completo,3412,"Técnicos Marítimos, Fluviários E Pescadores De Convés",2342.6623852039183,-105,1820,1925
5,Fundamental Completo,3413,Técnicos Marítimos E Fluviários De Máquinas,3394.2501194028287,-23,1082,1105
5,Fundamental Completo,3421,Especialistas Em Logística De Transportes,2178.4396999655532,474,4186,3712
5,Fundamental Completo,3422,Despachantes Aduaneiros,1995.7863570946226,-55,435,490
5,Fundamental Completo,3423,Técnicos Em Transportes Rodoviários,2697.312908014473,-1227,1771,2998
5,Fundamental Completo,3424,Técnicos Em Transportes Metroferroviários,1746.2254016425136,-128,231,359
5,Fundamental Completo,3425,Técnicos Em Transportes Aéreos,2278.6452597040584,-97,170,267
5,Fundamental Completo,3426,Técnicos Em Transportes Por Vias Navegáveis E Operações Portuárias,2632.584649234348,-49,55,104
5,Fundamental Completo,3511,Técnicos Em Contabilidade,2433.5048146388003,-64,86,150
5,Fundamental Completo,3513,Técnicos Em Administração,2207.031324839689,-63,196,259
5,Fundamental Completo,3514,Serventuários Da Justiça E Afins,2532.316124581274,-157,402,559
5,Fundamental Completo,3515,"Técnicos Em Secretariado, Taquígrafos E Estenotipistas",1760.4697908510173,-218,955,1173
5,Fundamental Completo,3516,Técnicos Em Segurança Do Trabalho,2593.022615545957,132,2904,2772
5,Fundamental Completo,3517,Técnicos De Seguros E Afins,2212.520919056598,-98,684,782
5,Fundamental Completo,3518,Agentes De Investigação E Identificação,1926.2533162434897,-5,1,6
5,Fundamental Completo,3519,Técnicos Da Inteligência,1325,1,2,1
5,Fundamental Completo,3522,Agentes Da Saúde E Do Meio Ambiente,1715.4416635335645,-116,1016,1132
5,Fundamental Completo,3523,Agentes  Fiscais Metrológicos E De Qualidade,2112.465133431673,-78,237,315
5,Fundamental Completo,3524,Profissionais De Direitos Autorais E De Avaliacão De Produtos Dos Meios De Comunicação,1559.1720296223957,-2,7,9
5,Fundamental Completo,3532,Técnicos Em Operações E Serviços Bancários,2801.6455866312535,-15,71,86
5,Fundamental Completo,3541,Especialistas Em Promoção De Produtos E Vendas,2443.357127159363,124,17024,16900
5,Fundamental Completo,3542,Compradores,2705.769431588472,-419,1064,1483
5,Fundamental Completo,3543,Analistas De Comércio Exterior,3139.1982393152575,-9,38,47
5,Fundamental Completo,3544,Leiloeiros E Avaliadores,1888.535401934217,-10,84,94
5,Fundamental Completo,3545,Corretores De Seguros,1444.3815248133772,-7,26,33
5,Fundamental Completo,3546,Corretores De Imóveis E De Grãos,1472.500643643466,3,95,92
5,Fundamental Completo,3547,Representantes Comerciais Autônomos,1592.9052506734492,1236,1417,181
5,Fundamental Completo,3548,Técnicos Em Serviços De Turismo E Organização De Eventos,2159.359710909586,-10,706,716
5,Fundamental Completo,3711,Técnicos Em Biblioteconomia,1262.0653338488792,0,102,102
5,Fundamental Completo,3712,Técnicos Em Museologia E Afins,1509.1933186848958,-4,1,5
5,Fundamental Completo,3713,Técnicos Em Artes Gráficas,2087.8930139329696,-9,66,75
5,Fundamental Completo,3714,Recreadores,1567.1775787599513,-43,2568,2611
5,Fundamental Completo,3721,Captadores De Imagens Em Movimento,3030.424104553352,-70,191,261
5,Fundamental Completo,3722,Operadores De Rede De Teleprocessamento E Afins,1670.6848218549865,2,230,228
5,Fundamental Completo,3731,Técnicos De Operação De Registros Sonoro/Audiovisuais,1942.4716380965883,-135,337,472
5,Fundamental Completo,3732,Supervisores Operacionais E Técnicos Em Mídias Audiovisuais,3049.2938086496856,-51,64,115
5,Fundamental Completo,3741,Técnicos Em Áudio,1664.6083848787569,-146,936,1082
5,Fundamental Completo,3742,Técnicos Em Cenografia,9586.475381969865,-22,112,134
5,Fundamental Completo,3743,Técnicos Em Operação De Aparelhos De Projeção,2004.0583362250868,-25,34,59
5,Fundamental Completo,3744,"Técnicos Em Montagem, Edição E Finalização De Mídia Audiovisual",2381.4872777044975,-38,1136,1174
5,Fundamental Completo,3751,"Designers De Interiores, De Vitrines E Visual Merchandiser E Afins (Nível Médio)",1884.1009888840488,-86,536,622
5,Fundamental Completo,3761,Dançarinos Tradicionais E Populares,1374.5596937699752,-13,4,17
5,Fundamental Completo,3762,Artistas De Circo (Circenses),1463.931128049481,-28,42,70
5,Fundamental Completo,3763,"Apresentadores De Eventos, Programas E Espetáculos",3628.6300251007083,28,91,63
5,Fundamental Completo,3764,Modelos,7047.710132594138,0,20,20
5,Fundamental Completo,3771,Atletas Profissionais,4159.315546015602,190,3452,3262
5,Fundamental Completo,3772,Árbitros Desportivos,4635.090914620293,-4,20,24
5,Fundamental Completo,3911,"Planejadores, Programadores E Controladores De Produção E Manutenção",3009.6411966874894,121,11574,11453
5,Fundamental Completo,3912,Técnicos De Controle Da Produção,2953.3624535608797,-1507,7150,8657
5,Fundamental Completo,3951,Técnicos De Apoio Em Pesquisa E Desenvolvimento,2037.125396917772,-12,377,389
5,Fundamental Completo,4101,Supervisores Administrativos,2524.724501316115,-4252,9281,13533
5,Fundamental Completo,4102,"Supervisores De Serviços Financeiros, De Câmbio E De Controle",2544.7377179515615,-900,1620,2520
5,Fundamental Completo,4110,"Agentes, Assistentes E Auxiliares Administrativos",1648.0506314827144,-3906,106592,110498
5,Fundamental Completo,4121,Operadores De Equipamentos De Entrada E Transmissão De Dados,1532.9440566402516,-44,674,718
5,Fundamental Completo,4122,Contínuos,1527.605770146595,-1810,16045,17855
5,Fundamental Completo,4131,Auxiliares De Contabilidade,2337.1698172470333,-568,3073,3641
5,Fundamental Completo,4132,Escriturários De Serviços Bancários,1461.2486219001812,-368,1504,1872
5,Fundamental Completo,4141,Almoxarifes E Armazenistas,1877.0183029716943,5367,137835,132468
5,Fundamental Completo,4142,Apontadores E Conferentes,2131.258646391993,-4235,21192,25427
5,Fundamental Completo,4151,"Auxiliares De Serviços De Documentação, Informação E Pesquisa",1490.1794891267364,-95,635,730
5,Fundamental Completo,4152,"Trabalhadores Nos Serviços De Classificação E Entregas De Correspondências, Encomendas E Publicações",3339.7101813276163,-530,1299,1829
5,Fundamental Completo,4153,Trabalhadores Em Registros E Informações Em Saúde,1859,0,2,2
5,Fundamental Completo,4201,Supervisores De Atendimento Ao Público E De Pesquisa,2115.715509491811,-624,789,1413
5,Fundamental Completo,4211,Caixas E Bilheteiros (Exceto Caixa De Banco),1489.281781257969,-7140,65298,72438
5,Fundamental Completo,4212,Coletadores De Apostas E De Jogos,1277.7275345636253,-173,1336,1509
5,Fundamental Completo,4213,Cobradores E Afins,1780.7480263063935,-1025,2335,3360
5,Fundamental Completo,4221,Recepcionistas,1595.298489625291,-2394,30146,32540
5,Fundamental Completo,4222,Operadores De Telefonia,1442.7701704427225,-499,1009,1508
5,Fundamental Completo,4223,Operadores De Telemarketing E Afins,1360.2013560294454,-469,8992,9461
5,Fundamental Completo,4231,Despachantes Documentalistas E Afins,2129.5656643159477,-83,754,837
5,Fundamental Completo,4241,Entrevistadores E Recenseadores,2369.8099252456173,7,540,533
5,Fundamental Completo,4242,Aplicadores De Provas E Afins,2104.260009765625,1,7,6
5,Fundamental Completo,5101,"Supervisores Dos Serviços De Transporte, Turismo, Hotelaria E Administração De Edifícios",3216.619866563146,-1065,2310,3375
5,Fundamental Completo,5102,Supervisores De Lavanderia,1836.9220836359164,-217,225,442
5,Fundamental Completo,5103,"Supervisores Dos Serviços De Proteção, Segurança E Outros",2418.9869556252806,-370,520,890
5,Fundamental Completo,5111,Trabalhadores De Segurança E Atendimento Aos Usuários Nos Transportes,1661.071487216087,-65,291,356
5,Fundamental Completo,5112,Fiscais E Cobradores Dos Transportes Coletivos,1596.5962259708185,-6710,4709,11419
5,Fundamental Completo,5114,Guias De Turismo,1450.1088540753603,-7,110,117
5,Fundamental Completo,5115,Condutores De Turismo,1630.9574192592077,27,66,39
5,Fundamental Completo,5121,Trabalhadores Dos Serviços Domésticos Em Geral,1516.5936579642876,697,5617,4920
5,Fundamental Completo,5131,Mordomos E Governantas,1621.8567086217452,-210,978,1188
5,Fundamental Completo,5132,Cozinheiros,1715.8475724403156,-9889,121226,131115
5,Fundamental Completo,5133,"Camareiros, Roupeiros E Afins",1588.9160812667258,-1253,29374,30627
5,Fundamental Completo,5134,"Trabalhadores No Atendimento Em Estabelecimentos De Serviços De Alimentação, Bebidas E Hotelaria",1747.6563675704992,-12572,137527,150099
5,Fundamental Completo,5135,Trabalhadores Auxiliares Nos Serviços De Alimentação,1536.8903488109338,3965,135994,132029
5,Fundamental Completo,5136,"Churrasqueiros, Pizzaiolos E Sushimen",1887.0444795743358,-627,10911,11538
5,Fundamental Completo,5141,Trabalhadores Nos Serviços De Administração De Edifícios,1652.3012068157036,-1755,52042,53797
5,Fundamental Completo,5142,"Trabalhadores Nos Serviços De Coleta De Resíduos, De Limpeza E Conservação De Áreas Públicas",1666.5401655482376,9926,144327,134401
5,Fundamental Completo,5143,Trabalhadores Nos  Serviços De Manutenção De Edificações,1745.3443292139211,47938,727216,679278
5,Fundamental Completo,5151,Trabalhadores Em Serviços De Promoção E Apoio À Saúde,1785.562279378309,-96,4116,4212
5,Fundamental Completo,5152,Auxiliares De Laboratório Da Saúde,1828.7585087431369,-304,3423,3727
5,Fundamental Completo,5153,"Trabalhadores De Atenção, Defesa E Proteção A Pessoas Em Situação De Risco E Adolescentes Em Conflito Com A Lei",1595.5358944483214,124,1745,1621
5,Fundamental Completo,5161,Trabalhadores Nos Serviços De Embelezamento E Higiene,1578.442010695451,-1461,1153,2614
5,Fundamental Completo,5162,"Cuidadores De Crianças, Jovens, Adultos E Idosos",3478.2878699264775,388,8994,8606
5,Fundamental Completo,5163,"Tintureiros, Lavadeiros E Afins, A Máquina",1652.8618180756152,-1113,18720,19833
5,Fundamental Completo,5164,"Lavadores E Passadores De Roupa, A Mão",1436.519408517018,-250,1207,1457
5,Fundamental Completo,5165,Trabalhadores Dos Serviços Funerários,1589.77715810746,-47,1419,1466
5,Fundamental Completo,5166,Trabalhadores Auxiliares Dos Serviços Funerários,1607.423282814752,188,1082,894
5,Fundamental Completo,5168,Esotéricos E Paranormais,2352,1,1,0
5,Fundamental Completo,5171,"Bombeiros, Salva-Vidas E Afins",3096.7358353697373,-200,1886,2086
5,Fundamental Completo,5172,"Policiais, Guardas-Civis Municipais E Agentes De Trânsito",1861.3022838933528,-94,828,922
5,Fundamental Completo,5173,Vigilantes E Guardas De Segurança,2184.441735178824,-7716,53443,61159
5,Fundamental Completo,5174,"Porteiros, Vigias E Afins",1763.6077508158892,-9253,130463,139716
5,Fundamental Completo,5191,Motociclistas E Ciclistas De Entregas Rápidas,1424.6097109834752,-1543,22200,23743
5,Fundamental Completo,5192,Trabalhadores Da Coleta E Seleção De Material Reciclável,1470.9337257250063,676,6366,5690
5,Fundamental Completo,5193,"Trabalhadores De Serviços Veterinários, De Higiene E Estética De Animais Domésticos",1937.2795079574535,-162,3152,3314
5,Fundamental Completo,5199,Outros Trabalhadores Dos Serviços,1653.7918501857541,-532,26102,26634
5,Fundamental Completo,5201,Supervisores De Vendas E De Prestação De Serviços,2160.1289495569013,-1847,1913,3760
5,Fundamental Completo,5211,Operadores Do Comércio Em Lojas E Mercados,2674.72099118515,-18029,374575,392604
5,Fundamental Completo,5231,Instaladores De Produtos E Acessórios,1658.5332230238478,-356,2355,2711
5,Fundamental Completo,5241,Vendedores Em Domicílio,1343.9763554641606,-377,3983,4360
5,Fundamental Completo,5242,"Vendedores Em Bancas, Quiosques E Barracas",1673.3844501313215,-121,458,579
5,Fundamental Completo,5243,Vendedores Ambulantes,1202.0467068814594,-148,547,695
5,Fundamental Completo,6110,Produtores Agropecuários Em Geral,1279.8854540394032,-8,919,927
5,Fundamental Completo,6120,Produtores Agrícolas Polivalentes,1430.257660057508,93,991,898
5,Fundamental Completo,6121,Produtores Agrícolas Na Cultura De Gramíneas,1398.80942668161,-26,145,171
5,Fundamental Completo,6123,Produtores Agrícolas Na Olericultura,1372.6195153413978,-19,97,116
5,Fundamental Completo,6124,Produtores Agrícolas No Cultivo De Flores E Plantas Ornamentais,1710.331422376766,13,99,86
5,Fundamental Completo,6125,Produtores Agrícolas Na Fruticultura,1363.6199126765705,5,184,179
5,Fundamental Completo,6126,Produtores Agrícolas Na Cultura De Plantas Estimulantes,1647.5872712899081,-1,12,13
5,Fundamental Completo,6127,Produtores Agrícolas Na Cultura De Plantas Oleaginosas,1652.0558737809408,8,58,50
5,Fundamental Completo,6128,Produtores De Especiarias E De Plantas Aromáticas E Medicinais,1288.9166666666665,3,6,3
5,Fundamental Completo,6130,Produtores Em Pecuária Polivalente,1401.5520068727196,-5,79,84
5,Fundamental Completo,6131,Produtores Em Pecuária De Animais De Grande Porte,1598.3840712954257,3,275,272
5,Fundamental Completo,6132,Produtores Em Pecuária De Animais De Médio Porte,2503.5371678567076,10,189,179
5,Fundamental Completo,6133,Produtores Da Avicultura E Cunicultura,1557.109806134505,-86,789,875
5,Fundamental Completo,6134,Produtores De Animais E Insetos Úteis,2398.1303565522544,-6,22,28
5,Fundamental Completo,6201,Supervisores Na Exploração Agropecuária,2954.738630233895,-378,7607,7985
5,Fundamental Completo,6210,Trabalhadores Agropecuários Em Geral,1529.1425591746402,5976,150469,144493
5,Fundamental Completo,6220,Trabalhadores De Apoio À Agricultura,1863.3484772301056,11811,162437,150626
5,Fundamental Completo,6221,Trabalhadores Agrícolas Na Cultura De Gramíneas,1757.018520884964,4425,82324,77899
5,Fundamental Completo,6222,Trabalhadores Agrícolas Na Cultura De Plantas Fibrosas,1553.1934561466367,1,482,481
5,Fundamental Completo,6223,Trabalhadores Agrícolas Na Olericultura,1397.5148642214938,160,6234,6074
5,Fundamental Completo,6224,Trabalhadores Agrícolas No Cultivo De Flores E Plantas Ornamentais,1429.8705865213685,663,5938,5275
5,Fundamental Completo,6225,Trabalhadores Agrícolas Na Fruticultura,2021.9080851399704,5591,88625,83034
5,Fundamental Completo,6226,Trabalhadores Agrícolas Nas Culturas De Plantas Estimulantes,1231.8512826995884,1056,24629,23573
5,Fundamental Completo,6227,Trabalhadores Agrícolas Na Cultura De Plantas Oleaginosas,1542.020356782854,898,5937,5039
5,Fundamental Completo,6228,Trabalhadores Agrícolas Da Cultura De Especiarias E De Plantas Aromáticas E Medicinais,1259.768348916442,4,168,164
5,Fundamental Completo,6230,Tratadores Polivalentes De Animais,1841.499232954847,232,10770,10538
5,Fundamental Completo,6231,Trabalhadores Na Pecuária De Animais De Grande Porte,1698.1478808803288,1217,35405,34188
5,Fundamental Completo,6232,Trabalhadores Na Pecuária De Animais De Médio Porte,1445.74331153223,110,6532,6422
5,Fundamental Completo,6233,Trabalhadores Na Avicultura E Cunicultura,1443.0630899193409,1377,28125,26748
5,Fundamental Completo,6234,Trabalhadores Na Criação De Insetos E Animais Úteis,1398.8059484635228,-12,208,220
5,Fundamental Completo,6301,Supervisores Na Área Florestal E Aqüicultura,2390.8264641614724,-54,736,790
5,Fundamental Completo,6310,Pescadores Polivalentes,1263.1744122866385,-30,125,155
5,Fundamental Completo,6311,Pescadores Profissionais Artesanais De Água Doce,1376.996342295224,-4,95,99
5,Fundamental Completo,6312,Pescadores De Água Costeira E Alto Mar,1960.7200151882444,139,8895,8756
5,Fundamental Completo,6313,Criadores De Animais Aquáticos,1716.9438370727785,209,1633,1424
5,Fundamental Completo,6314,Trabalhadores De Apoio À Pesca,1671.0128476859181,24,177,153
5,Fundamental Completo,6320,Trabalhadores Florestais Polivalentes,1671.6396180196953,199,1078,879
5,Fundamental Completo,6321,Extrativistas E Reflorestadores De Espécies Produtoras De Madeira,1931.4966852046514,3282,34146,30864
5,Fundamental Completo,6322,Extrativistas Florestais De Espécies Produtoras De Gomas E Resinas,1963.9907695036575,-27,3964,3991
5,Fundamental Completo,6323,"Extrativistas Florestais De Espécies Produtoras De Fibras, Ceras E Óleos",1960.7573974634731,89,1793,1704
5,Fundamental Completo,6324,Extrativistas Florestais De Espécies Produtoras De Alimentos Silvestres,1216.469061135282,15,440,425
5,Fundamental Completo,6325,"Extrativistas Florestais De Espécies Produtoras De Substâncias Aromáticas, Medicinais E Tóxicas",1377.6631526834778,-19,183,202
5,Fundamental Completo,6326,Carvoejadores,1405.2785458087592,710,6168,5458
5,Fundamental Completo,6410,Trabalhadores Da Mecanização Agrícola,6473.630518866018,5825,84431,78606
5,Fundamental Completo,6420,Trabalhadores Da Mecanização Florestal,2028.1947969542034,100,5504,5404
5,Fundamental Completo,6430,Trabalhadores Da Irrigação E Drenagem,1564.3527619479348,136,1639,1503
5,Fundamental Completo,7101,Supervisores Da Extração Mineral,3281.7121724068957,-70,390,460
5,Fundamental Completo,7102,Supervisores Da Construção Civil,4458.062660402893,-1098,30092,31190
5,Fundamental Completo,7111,Trabalhadores Da Extração De Minerais Sólidos,1830.6402461707685,72,4560,4488
5,Fundamental Completo,7112,Trabalhadores De Extração De Minerais Sólidos (Operadores De Máquinas),3539.510478317967,504,9684,9180
5,Fundamental Completo,7113,Trabalhadores Da Extração De Minerais Líquidos E Gasosos,3915.115622942712,96,2654,2558
5,Fundamental Completo,7114,Garimpeiros E Operadores De Salinas,1196.3241273227518,31,189,158
5,Fundamental Completo,7121,Trabalhadores De Beneficiamento De Minérios,1872.6643715805487,129,1974,1845
5,Fundamental Completo,7122,Trabalhadores De Beneficiamento De Pedras Ornamentais,2620.642945501555,-321,5115,5436
5,Fundamental Completo,7151,Trabalhadores Na Operação De Máquinas De Terraplenagem E Fundações,2698.499869472115,2274,58679,56405
5,Fundamental Completo,7152,Trabalhadores De Estruturas De Alvenaria,2360.8437327414053,10201,239659,229458
5,Fundamental Completo,7153,Montadores De Estruturas De Concreto Armado,2502.355252474639,2381,48278,45897
5,Fundamental Completo,7154,Trabalhadores Na Operação De Máquinas De Concreto Usinado E Afins,2182.30720769202,-642,6593,7235
5,Fundamental Completo,7155,"Trabalhadores De Montagem De Estruturas De Madeira, Metal E Compósitos Em Obras Civis",2485.9887691539607,5604,106999,101395
5,Fundamental Completo,7156,Trabalhadores De Instalações Elétricas,2943.6503784911997,1179,31461,30282
5,Fundamental Completo,7157,Aplicadores De Materiais Isolantes,3775.854922943632,197,6070,5873
5,Fundamental Completo,7161,Revestidores De Concreto,2195.2098881690326,-78,933,1011
5,Fundamental Completo,7162,Telhadores (Revestimentos Rígidos),1965.009881228747,44,599,555
5,Fundamental Completo,7163,Vidraceiros (Revestimentos Rígidos),1784.0419931013819,-189,4680,4869
5,Fundamental Completo,7164,Gesseiros,2327.149313043361,782,14324,13542
5,Fundamental Completo,7165,"Aplicadores De Revestimentos Cerâmicos, Pastilhas, Pedras E Madeiras",2258.706305381335,279,10118,9839
5,Fundamental Completo,7166,Pintores De Obras E Revestidores De Interiores (Revestimentos Flexíveis),2663.0992797650706,1123,39027,37904
5,Fundamental Completo,7170,Ajudantes De Obras Civis,95959.1649089179,59481,528636,469155
5,Fundamental Completo,7201,"Supervisores De Usinagem, Conformação E Tratamento De Metais",4779.579055310989,-396,1544,1940
5,Fundamental Completo,7202,Supervisores Da Fabricação E Montagem Metalmecânica,3859.808585444788,-299,285,584
5,Fundamental Completo,7211,Ferramenteiros E Afins,6351.704298235608,-528,1555,2083
5,Fundamental Completo,7212,Preparadores E Operadores De Máquinas-Ferramenta Convencionais,3959.9726233162537,-2528,12443,14971
5,Fundamental Completo,7213,Afiadores E Polidores De Metais,2066.740453548625,-179,4104,4283
5,Fundamental Completo,7214,Operadores De Máquinas De Usinagem Cnc,5200.0932346497675,-268,2911,3179
5,Fundamental Completo,7221,Trabalhadores De Forjamento De Metais,2306.899790885463,78,2788,2710
5,Fundamental Completo,7222,Trabalhadores De Fundição De Metais Puros E De Ligas Metálicas,4012.979728663104,194,6479,6285
5,Fundamental Completo,7223,Trabalhadores De Moldagem De Metais E De Ligas Metálicas,2445.2906737876788,-142,2578,2720
5,Fundamental Completo,7224,Trabalhadores De Trefilação E Estiramento De Metais Puros E Ligas Metálicas,2010.678654920638,-184,303,487
5,Fundamental Completo,7231,Trabalhadores De Tratamento Térmico De Metais,2270.5285580400587,-15,510,525
5,Fundamental Completo,7232,Trabalhadores De Tratamento De Superfícies De Metais E De Compósitos (Termoquímicos),2132.8763879674716,-134,1948,2082
5,Fundamental Completo,7233,"Trabalhadores Da Pintura De Equipamentos, Veículos, Estruturas Metálicas E De Compósitos",2505.6565969173353,-729,16747,17476
5,Fundamental Completo,7241,Encanadores E Instaladores De Tubulações,2912.534769464696,633,31931,31298
5,Fundamental Completo,7242,Trabalhadores De Traçagem E Montagem De Estruturas Metálicas E De Compósitos,4220.21013952106,2849,46099,43250
5,Fundamental Completo,7243,Trabalhadores De Soldagem E Corte De Ligas Metálicas,4274.047648614022,-327,53507,53834
5,Fundamental Completo,7244,Trabalhadores De Caldeiraria E Serralheria,4740.658616937259,400,35998,35598
5,Fundamental Completo,7245,Operadores De Máquinas De Conformação De Metais,3260.0374264529055,-873,4595,5468
5,Fundamental Completo,7246,Trançadores E Laceiros De Cabos De Aço,3479.7056353251137,-38,96,134
5,Fundamental Completo,7250,Ajustadores Mecânicos Polivalentes E Afins,2497.275964334192,-133,5624,5757
5,Fundamental Completo,7251,"Montadores De Máquinas, Aparelhos E Acessórios Em Linhas De Montagem",5963.788908442209,189,4846,4657
5,Fundamental Completo,7252,Montadores De Máquinas Industriais,2546.0404871922524,1033,15694,14661
5,Fundamental Completo,7253,Montadores De Máquinas Pesadas E Equipamentos Agrícolas,2796.4734774077456,98,1072,974
5,Fundamental Completo,7254,Mecânicos Montadores De Motores E Turboalimentadores,2418.0019246612155,52,793,741
5,Fundamental Completo,7255,Montadores De Veículos Automotores (Linha De Montagem),2117.4201101236613,-675,1081,1756
5,Fundamental Completo,7256,Montadores De Sistemas E Estruturas De Aeronaves,1624.4277089436848,-8,9,17
5,Fundamental Completo,7257,Instaladores De Equipamentos De Refrigeração E Ventilação,1951.8449584497612,-281,1783,2064
5,Fundamental Completo,7301,Supervisores De Montagens E Instalações Eletroeletrônicas,8302.074004724429,-114,405,519
5,Fundamental Completo,7311,Montadores De Equipamentos Eletroeletrônicos,2201.2055318012326,-322,18327,18649
5,Fundamental Completo,7312,Montadores De Aparelhos De Telecomunicações,1476.9091751797337,-85,296,381
5,Fundamental Completo,7313,Instaladores-Reparadores De  Linhas E Equipamentos De Telecomunicações,1536.5797990754897,-340,2839,3179
5,Fundamental Completo,7321,"Instaladores E Reparadores De Linhas E Cabos Elétricos, Telefônicos E De Comunicação De Dados",4391.813310762431,-352,15947,16299
5,Fundamental Completo,7401,Supervisores Da Mecânica De Precisão E Instrumentos Musicais,9486.284102770078,-16,41,57
5,Fundamental Completo,7411,Mecânicos De Instrumentos De Precisão,3129.0983890599027,-69,652,721
5,Fundamental Completo,7421,Confeccionadores De Instrumentos Musicais,1578.6670024326868,-21,42,63
5,Fundamental Completo,7501,Supervisores De Joalheria E Afins,2560.1215087890623,-6,7,13
5,Fundamental Completo,7502,"Supervisores De Vidraria, Cerâmica E Afins",3293.310006534352,-24,22,46
5,Fundamental Completo,7510,Joalheiros E Lapidadores De Gemas,1779.509422649121,-83,262,345
5,Fundamental Completo,7511,Artesãos De Metais Preciosos E Semi-Preciosos,1762.7625791281962,-109,497,606
5,Fundamental Completo,7521,"Sopradores, Moldadores E Modeladores De Vidros E Afins",2319.4957823935674,-13,168,181
5,Fundamental Completo,7522,Trabalhadores Da Transformação De Vidros Planos,1761.2911249157637,-213,767,980
5,Fundamental Completo,7523,Ceramistas (Preparação E Fabricação),1834.126859717517,98,8577,8479
5,Fundamental Completo,7524,Vidreiros E Ceramistas (Arte E Decoração),1808.8602368240875,-111,382,493
5,Fundamental Completo,7601,Supervisores Da Indústria Têxtil,4316.263681229774,-348,1261,1609
5,Fundamental Completo,7602,Supervisores Na Indústria Do Curtimento,25956.251478407117,-7,10,17
5,Fundamental Completo,7603,Supervisores Na Confecção Do Vestuário,2312.2562090953024,-538,875,1413
5,Fundamental Completo,7604,Supervisores Na Confecção De Calçados,3028.0395215623876,-371,880,1251
5,Fundamental Completo,7605,"Supervisores Da Confecção De Artefatos De Tecidos, Couros E Afins",3545.114636230469,-130,135,265
5,Fundamental Completo,7606,Supervisores Das Artes Gráficas,3109.361396550063,-79,72,151
5,Fundamental Completo,7610,Trabalhadores Polivalentes Das Indústrias Têxteis,2169.867907341276,-582,5219,5801
5,Fundamental Completo,7611,Trabalhadores Da Classificação De Fibras Têxteis E Lavagem De Lã,1537.815251232329,10,229,219
5,Fundamental Completo,7612,Operadores Da Fiação,2048.827731997534,-627,2104,2731
5,Fundamental Completo,7613,Operadores De Tear E Máquinas Similares,2592.927316631062,-1024,5527,6551
5,Fundamental Completo,7614,"Trabalhadores De Acabamento, Tingimento E Estamparia Das Indústrias Têxteis",2423.3243182301076,-473,3793,4266
5,Fundamental Completo,7618,Inspetores E Revisores De Produção Têxtil,23142.46956876048,-443,6310,6753
5,Fundamental Completo,7620,Trabalhadores Polivalentes Do Curtimento De Couros E Peles,1502.2056717407559,148,4174,4026
5,Fundamental Completo,7621,Trabalhadores Da Preparação Do Curtimento De Couros E Peles,3034.775499308538,-107,229,336
5,Fundamental Completo,7622,Trabalhadores Do Curtimento De Couros E Peles,1802.7781533010898,-16,640,656
5,Fundamental Completo,7623,Trabalhadores Do Acabamento De Couros E Peles,2243.9916989047206,-217,1095,1312
5,Fundamental Completo,7630,Profissionais Polivalentes Da Confecção De Roupas,1711.9677119358,-1301,6148,7449
5,Fundamental Completo,7631,Trabalhadores Da Preparação Da Confecção De Roupas,45028.7748943371,-344,22491,22835
5,Fundamental Completo,7632,Operadores De Máquinas Para Costura De Peças Do Vestuário,1668.6479882581723,-6679,54192,60871
5,Fundamental Completo,7633,Operadores De Máquinas Para Bordado E Acabamento De Roupas,1478.6275394611127,-1003,6238,7241
5,Fundamental Completo,7640,Trabalhadores Polivalentes Da Confecção De Calçados,1485.337484735189,98,21654,21556
5,Fundamental Completo,7641,Trabalhadores Da Preparação Da Confecção De Calçados,1542.1802279385486,-1018,13822,14840
5,Fundamental Completo,7642,Operadores De Máquinas De Costurar E Montar Calçados,1703.4850384341341,-1384,6745,8129
5,Fundamental Completo,7643,Trabalhadores De Acabamento De Calçados,1554.3679380065666,-570,4243,4813
5,Fundamental Completo,7650,Trabalhadores Polivalentes Da Confecção De Artefatos De Tecidos E Couros,1408.726532650714,-28,261,289
5,Fundamental Completo,7651,"Trabalhadores Da Preparação De Artefatos De Tecidos, Couros E Tapeçaria",2128.110406910502,-141,799,940
5,Fundamental Completo,7652,"Trabalhadores Da Confecção De Artefatos De Tecidos, Couros E Sintéticos",1736.0896736197674,-167,3940,4107
5,Fundamental Completo,7653,Operadores De Máquinas Na Confecção De Artefatos De  Couro,2769.8853422139255,-64,743,807
5,Fundamental Completo,7654,Trabalhadores Do Acabamento De Artefatos De Tecidos E Couros,1376.0462498899583,-60,874,934
5,Fundamental Completo,7661,Trabalhadores Da Pré-Impressão Gráfica,1857.0334670101856,-224,908,1132
5,Fundamental Completo,7662,Trabalhadores Da Impressão Gráfica,2773.3583510970057,-1054,3567,4621
5,Fundamental Completo,7663,Trabalhadores Do Acabamento Gráfico,2217.3422374702036,-621,3905,4526
5,Fundamental Completo,7664,Trabalhadores De Laboratório Fotográfico E Radiológico,1647.6457546035092,-37,115,152
5,Fundamental Completo,7681,"Trabalhadores De Tecelagem Manual, Tricô, Crochê, Rendas E Afins",1542.4046878418565,-68,283,351
5,Fundamental Completo,7682,Trabalhadores Artesanais Da Confecção De Peças E Tecidos,1514.1088535247586,-46,212,258
5,Fundamental Completo,7683,Trabalhadores Artesanais Da Confecção De Calçados E Artefatos De Couros E Peles,2091.5742444328557,-195,2538,2733
5,Fundamental Completo,7686,Trabalhadores Tipográficos Linotipistas E Afins,2170.7476517355826,-55,275,330
5,Fundamental Completo,7687,Encadernadores E Recuperadores De Livros (Pequenos Lotes Ou A Unidade),1660.8766179807258,-34,57,91
5,Fundamental Completo,7701,"Supervisores Em Indústria De Madeira, Mobiliário E Da Carpintaria Veicular",3616.499259931931,-301,1131,1432
5,Fundamental Completo,7711,Marceneiros E Afins,2331.1329986925025,-702,13938,14640
5,Fundamental Completo,7721,Trabalhadores De Tratamento E Preparação Da Madeira,1604.8372955836119,293,5878,5585
5,Fundamental Completo,7731,Operadores De Máquinas De Desdobramento Da Madeira,2721.6600916975926,-954,8206,9160
5,Fundamental Completo,7732,Operadores De Máquinas De Aglomeração E Prensagem De Chapas,1682.0448998793213,-82,391,473
5,Fundamental Completo,7733,Operadores De Usinagem Convencional De Madeira,2434.57259788317,-855,4980,5835
5,Fundamental Completo,7734,Operadores De Máquina De Usinar Madeira (Produção Em Série),1679.8977041937405,-243,1367,1610
5,Fundamental Completo,7735,Operadores De Máquinas De Usinagem De Madeira Cnc,1787.513339238984,-98,447,545
5,Fundamental Completo,7741,Montadores De Móveis E Artefatos De Madeira,92586.66139526309,-1446,10808,12254
5,Fundamental Completo,7751,Trabalhadores De Arte E  Do Acabamento Em Madeira Do Mobiliário,1706.5658587796786,-136,1069,1205
5,Fundamental Completo,7764,"Confeccionadores De Artefatos De Madeira, Móveis De Vime E Afins",1496.6397209372738,-57,301,358
5,Fundamental Completo,7771,Carpinteiros Navais,2296.9194915680555,32,99,67
5,Fundamental Completo,7772,Carpinteiros De Carrocerias E Carretas,1807.9255176874685,-19,119,138
5,Fundamental Completo,7801,Supervisores De Trabalhadores De Embalagem E Etiquetagem,4364.474180972264,-194,246,440
5,Fundamental Completo,7811,Condutores De Processos Robotizados,2176.5941926969517,-16,96,112
5,Fundamental Completo,7813,Operadores De Equipamentos Pilotados Remotamente,2351.385333508403,11,49,38
5,Fundamental Completo,7817,Trabalhadores Subaquáticos,2095.447943947532,17,91,74
5,Fundamental Completo,7821,Operadores De Máquinas E Equipamentos De Elevação,2778.7555203584075,-115,9540,9655
5,Fundamental Completo,7822,Operadores De Equipamentos De Movimentação De Cargas,2081.3640256521153,-3436,15716,19152
5,Fundamental Completo,7823,Motoristas De Veículos De Pequeno E Médio Porte,1948.3265052748025,-6964,55126,62090
5,Fundamental Completo,7824,"Motoristas De Ônibus Urbanos, Metropolitanos E Rodoviários",2455.605225377632,-12412,44902,57314
5,Fundamental Completo,7825,Motoristas De Veículos De Cargas Em Geral,2696.4414593691586,2235,270459,268224
5,Fundamental Completo,7826,Operadores De Veículos Sobre Trilhos E Cabos Aéreos,7477.585176443459,-67,124,191
5,Fundamental Completo,7827,Trabalhadores Aquaviários,1984.2275862759686,-308,2882,3190
5,Fundamental Completo,7828,Condutores De Animais E De Veículos De Tração Animal E Pedais,1646.2873458684649,-79,442,521
5,Fundamental Completo,7831,Trabalhadores De Manobras De Transportes Sobre Trilhos,2649.796937336583,-218,2039,2257
5,Fundamental Completo,7832,Trabalhadores De Cargas E Descargas De Mercadorias,1636.2271036820568,7096,161773,154677
5,Fundamental Completo,7841,Trabalhadores De Embalagem E De Etiquetagem,1822.203394263504,255,49547,49292
5,Fundamental Completo,7842,Alimentadores De Linhas De Produção,2140.263195740418,36092,366010,329918
5,Fundamental Completo,7911,Artesãos,1428.9234885324386,22,189,167
5,Fundamental Completo,8101,"Supervisores De Produção Em Indústrias Químicas, Petroquímicas E Afins",3264.7856028760107,-151,81,232
5,Fundamental Completo,8102,Supervisores De Produção Em Indústrias De Transformação De Plásticos E Borrachas,2807.8641289029338,-193,198,391
5,Fundamental Completo,8103,"Supervisores De Produção Em Indústrias De Produtos Farmacêuticos, Cosméticos E Afins",2601.544325764974,-10,10,20
5,Fundamental Completo,8110,"Operadores Polivalentes De Equipamentos Em Indústrias Químicas, Petroquímicas E Afins",1914.1533343189612,-55,195,250
5,Fundamental Completo,8111,Operadores De Equipamentos De Moagem E Mistura De Materiais (Tratamentos Químicos E Afins),1787.695781935883,-259,1447,1706
5,Fundamental Completo,8112,Operadores De Calcinação E De Tratamentos Químicos De Materiais Radioativos,2181.593878467631,-59,158,217
5,Fundamental Completo,8113,Operadores De Equipamentos De Filtragem E Separação,2782.310903830825,-80,370,450
5,Fundamental Completo,8114,"Operadores De Equipamentos De Destilação, Evaporação E Reação",2720.2635447844937,22,666,644
5,Fundamental Completo,8115,Operadores De Equipamentos De Produção E Refino De Petróleo E Gás,1924.6694343687996,-5,49,54
5,Fundamental Completo,8116,Operadores De Equipamentos De Coqueificação,1736.3167684758944,-77,307,384
5,Fundamental Completo,8117,"Operadores De Instalações E Máquinas De Produtos Plásticos, De Borracha E Moldadores De Parafinas",2142.8731173651768,-1397,13852,15249
5,Fundamental Completo,8118,"Operadores De Máquinas E Instalações De Produtos Farmacêuticos, Cosméticos E Afins",1849.901314004044,-306,706,1012
5,Fundamental Completo,8121,Trabalhadores Da Fabricação De Munição E Explosivos Químicos,1365.3234364653586,-4,238,242
5,Fundamental Completo,8131,"Operadores De Processos Das Indústrias De Transformação De Produtos Químicos, Petroquímicos E Afins",3202.153555192174,-227,6393,6620
5,Fundamental Completo,8181,Laboratoristas Industriais Auxiliares,8214.476653953523,19,1698,1679
5,Fundamental Completo,8201,Supervisores De Produção Em Indústrias Siderúrgicas,3049.991322573385,-48,67,115
5,Fundamental Completo,8202,Supervisores Na Fabricação De Materiais Para Construção (Vidros E Cerâmicas),6423.619452422155,-163,291,454
5,Fundamental Completo,8211,Operadores De Instalações De Sinterização,1748.7298192711028,-43,150,193
5,Fundamental Completo,8212,Operadores De Fornos De Primeira  Fusão E Aciaria,2264.4628619412656,-43,2993,3036
5,Fundamental Completo,8213,Operadores De Equipamentos De Laminação,2854.567070493675,-168,1138,1306
5,Fundamental Completo,8214,Operadores De Equipamentos De Acabamento De Chapas E Metais,5496.814675118875,59,10938,10879
5,Fundamental Completo,8221,Forneiros Metalúrgicos (Segunda Fusão E Reaquecimento),2828.7431625214317,-128,568,696
5,Fundamental Completo,8231,"Operadores Na Preparação De Massas Para Abrasivo, Vidro, Cerâmica, Porcelana E Materiais De Construção",2066.7372789757346,-21,504,525
5,Fundamental Completo,8232,"Operadores De Equipamentos De Fabricação  E Beneficiamento De Cristais, Vidros, Cerâmicas, Porcelanas, Fibras De Vidro, Abrasivos E Afins",2728.577626278638,-139,1023,1162
5,Fundamental Completo,8233,Operadores De Instalações E Equipamentos De Fabricação De Materiais De Construção,1613.3761205043834,603,9754,9151
5,Fundamental Completo,8281,Trabalhadores Da Fabricação De Cerâmica Estrutural Para Construção,2497.8281955886373,493,11129,10636
5,Fundamental Completo,8301,Supervisores Da Fabricação De Celulose E Papel,9640.323449599004,-24,101,125
5,Fundamental Completo,8311,Preparadores De Pasta Para Fabricação De Papel,1941.3727200889912,-46,192,238
5,Fundamental Completo,8321,Operadores De Máquinas De Fabricar Papel E Papelão,2808.265083438819,-375,1193,1568
5,Fundamental Completo,8331,Operadores De Máquinas Na Fabricação De Produtos De Papel E Papelão,1851.2840765659498,-207,1676,1883
5,Fundamental Completo,8332,Trabalhadores Artesanais De Produtos De Papel E Papelão,1704.4753931525927,29,685,656
5,Fundamental Completo,8401,"Supervisores Da Fabricação De Alimentos, Bebidas E Fumo",3889.9901126694303,-597,740,1337
5,Fundamental Completo,8411,"Trabalhadores Da Indústria De Beneficiamento De Grãos, Cereais E Afins",2260.0552149494724,-9,2656,2665
5,Fundamental Completo,8412,Trabalhadores No Beneficiamento Do Sal,1678.5730216971056,21,390,369
5,Fundamental Completo,8413,Trabalhadores Na Fabricação E Refino De Açúcar,13215.2250848218,-46,1633,1679
5,Fundamental Completo,8414,Trabalhadores Na Fabricação E Conservação De Alimentos,1679.4064135703222,-826,15990,16816
5,Fundamental Completo,8415,Trabalhadores Na Pasteurização Do Leite E Na Fabricação De Laticínios  E Afins,1693.833044497632,-119,4744,4863
5,Fundamental Completo,8416,"Trabalhadores Na Industrialização De Café, Cacau, Mate E De Produtos Afins",1344.1243522871957,-68,256,324
5,Fundamental Completo,8417,"Trabalhadores Na Fabricação De Cachaça, Cerveja, Vinhos E Outras Bebidas",2346.7695110128343,72,1703,1631
5,Fundamental Completo,8418,"Operadores De Equipamentos Na Fabricação De Pães, Massas Alimentícias, Doces, Chocolates E Achocolatados",2113.5161820066264,-1123,3007,4130
5,Fundamental Completo,8421,Cigarreiros E Beneficiadores De Fumo,1482.8908467247209,264,8228,7964
5,Fundamental Completo,8422,Charuteiros,1555.3742400330382,3,18,15
5,Fundamental Completo,8481,Trabalhadores Artesanais Na Conservação De Alimentos,1524.8580236734451,-349,1939,2288
5,Fundamental Completo,8482,Trabalhadores Artesanais Na Pasteurização Do Leite E Na Fabricação De Laticínios E Afins,1569.178332472793,-74,847,921
5,Fundamental Completo,8483,"Padeiros, Confeiteiros E Afins",1836.0179074793464,-5422,25089,30511
5,Fundamental Completo,8484,Trabalhadores Na Degustação E Classificação De Grãos E Afins,1686.1028263191315,-133,1671,1804
5,Fundamental Completo,8485,Magarefes E Afins,1646.9992812569417,-1048,103804,104852
5,Fundamental Completo,8486,Trabalhadores Artesanais Na Indústria Do Fumo,1409.4445683483198,165,1799,1634
5,Fundamental Completo,8601,Supervisores Da Produção De Utilidades,3423.7840505136046,-258,440,698
5,Fundamental Completo,8611,"Operadores De Instalações De Geração E Distribuição De Energia Elétrica, Hidráulica, Térmica Ou Nuclear",5039.269613248578,-59,283,342
5,Fundamental Completo,8612,Operadores De Instalações De Distribuição De Energia Elétrica,4522.597309282631,-96,109,205
5,Fundamental Completo,8621,Operadores De Máquinas A Vapor E Utilidades,5008.049976374901,-3845,23798,27643
5,Fundamental Completo,8622,"Operadores De Instalações De Captação, Tratamento E Distribuição De Água",2858.234893253871,42,812,770
5,Fundamental Completo,8623,Operadores De Instalações De Captação E Esgotos,1850.8237836600415,-18,2357,2375
5,Fundamental Completo,8624,"Operadores De Instalações De Extração, Processamento, Envasamento E Distribuição De Gases",3081.8983729184583,-13,157,170
5,Fundamental Completo,8625,Operadores De Instalações De Refrigeração E Ar-Condicionado,4890.538761451295,-57,588,645
5,Fundamental Completo,9101,"Supervisores Em Serviços De Reparação E Manutenção De Máquinas E Equipamentos Industriais, Comerciais E Residenciais",6519.974644763075,-377,2102,2479
5,Fundamental Completo,9102,Supervisores Em Serviços De Reparação E Manutenção Veicular,2883.405704781953,-141,432,573
5,Fundamental Completo,9109,"Supervisores De Outros Trabalhadores De Serviços De Reparação, Conservação E Manutenção",2725.1820864100255,-11,116,127
5,Fundamental Completo,9111,"Mecânicos De Manutenção De Bombas, Motores, Compressores E Equipamentos De Transmissão",2486.2948276441757,-96,2981,3077
5,Fundamental Completo,9112,Mecânicos De Manutenção E Instalação De Aparelhos De  Climatização E Refrigeração,1959.3125298729346,-86,3886,3972
5,Fundamental Completo,9113,Mecânicos De Manutenção De Máquinas Industriais,3079.6068910029326,249,30122,29873
5,Fundamental Completo,9131,Mecânicos De Manutenção De Máquinas Pesadas E Equipamentos Agrícolas,3193.759659865317,290,7177,6887
5,Fundamental Completo,9141,Mecânicos De Manutenção Aeronáutica,2008.3228803503741,-78,211,289
5,Fundamental Completo,9142,Mecânicos De Manutenção De Motores E Equipamentos Navais,2249.5128038194443,-5,65,70
5,Fundamental Completo,9143,Mecânicos De Manutenção Metroferroviária,2324.3809962706982,-103,459,562
5,Fundamental Completo,9144,Mecânicos De Manutenção De Veículos Automotores,2771.765720199688,-1725,36331,38056
5,Fundamental Completo,9151,Técnicos Em Manutenção E Reparação De Instrumentos De Medição E Precisão,2297.1818583405056,-20,271,291
5,Fundamental Completo,9152,Restauradores De Instrumentos Musicais,1723.8224500868055,-2,9,11
5,Fundamental Completo,9153,Técnicos Em Manutenção E Reparação De Equipamentos Biomédicos,2008.2089149624694,2,52,50
5,Fundamental Completo,9154,Reparadores De Equipamentos Fotográficos,1362.7030029296875,0,5,5
5,Fundamental Completo,9191,Lubrificadores,2430.0057449410137,-359,4299,4658
5,Fundamental Completo,9192,"Trabalhadores De Manutenção De Roçadeiras, Motoserras E Similares",2260.1202583354484,-98,2914,3012
5,Fundamental Completo,9193,Mecânicos De Manutenção De Bicicletas E Equipamentos Esportivos E De Ginástica,1592.1977399667385,-117,1141,1258
5,Fundamental Completo,9501,"Supervisores De Manutenção Eletroeletrônica Industrial, Comercial E Predial",4327.288837461325,-237,1470,1707
5,Fundamental Completo,9502,Supervisores De Manutenção Eletroeletrônica Veicular,2462.022380310812,-80,122,202
5,Fundamental Completo,9503,Supervisores De Manutenção Eletromecânica,5381.999133795309,-53,208,261
5,Fundamental Completo,9511,Eletricistas De Manutenção Eletroeletrônica,2869.9576610190743,-1045,11499,12544
5,Fundamental Completo,9513,Instaladores E Mantenedores De Sistemas Eletroeletrônicos De Segurança,1594.5227376433804,12,3261,3249
5,Fundamental Completo,9531,"Eletricistas Eletrônicos De Manutenção Veicular (Aérea, Terrestre E Naval)",2841.370781108526,-398,3359,3757
5,Fundamental Completo,9541,"Instaladores E Mantenedores Eletromecânicos De Elevadores, Escadas E Portas Automáticas",2299.811721675567,-107,1941,2048
5,Fundamental Completo,9542,Reparadores De Aparelhos Eletrodomésticos,1563.9193751261782,-66,201,267
5,Fundamental Completo,9543,Reparadores De Equipamentos De Escritório,1706.3430756855012,-10,70,80
5,Fundamental Completo,9911,Conservadores De Vias Permanentes (Trilhos),2402.15930772512,281,3447,3166
5,Fundamental Completo,9912,Mantenedores De Equipamentos De Parques De Diversões E Similares,1971.697988775712,-54,289,343
5,Fundamental Completo,9913,Reparadores De Carrocerias De Veículos,2042.6527650582113,-895,5581,6476
5,Fundamental Completo,9914,Mantenedores de edificações,1611.300048828125,-1,0,1
5,Fundamental Completo,9921,Trabalhadores Elementares De Serviços De Manutenção Veicular,2008.5654803020875,-178,9417,9595
5,Fundamental Completo,9922,Trabalhadores Operacionais De Conservação De Vias Permanentes (Exceto Trilhos),1994.7776091066512,1172,38390,37218
6,Médio Incompleto,0000,Não especificado,1260.4463028950606,483,742,259
6,Médio Incompleto,0101,Oficiais Generais Das Forças Armadas,5479.814741148489,-12,139,151
6,Médio Incompleto,0102,Oficiais Das Forças Armadas,1783.492350825557,0,19,19
6,Médio Incompleto,0103,Praças Das Forças Armadas,1690.7695928748678,6,29,23
6,Médio Incompleto,0201,Oficiais Superiores Da Polícia Militar,887.8461538461538,-1,6,7
6,Médio Incompleto,0211,Subtenentes E Sargentos Da Policia Militar,1177.5,2,3,1
6,Médio Incompleto,0301,Oficiais Superiores Do Corpo De Bombeiros Militar,1251,0,2,2
6,Médio Incompleto,0302,Oficiais Intermediários Do Corpo De Bombeiros Militar,1320,0,1,1
6,Médio Incompleto,0303,Tenentes Do Corpo De Bombeiros Militar,3273.22998046875,-1,0,1
6,Médio Incompleto,0312,Cabos E Soldados Do Corpo De Bombeiros Militar,2101.760009765625,1,2,1
6,Médio Incompleto,1111,Legisladores,1867.8737400619502,27,79,52
6,Médio Incompleto,1112,Dirigentes Gerais Da Administração Pública,1642.5665225236776,16,100,84
6,Médio Incompleto,1113,Magistrados,1894.0699462890625,0,1,1
6,Médio Incompleto,1114,Dirigentes Do Serviço Público,1523.513684589175,104,387,283
6,Médio Incompleto,1115,Gestores Públicos,2465.9071350097656,16,36,20
6,Médio Incompleto,1130,"Dirigentes De Povos Indígenas, De Quilombolas E Caiçaras",1685.9636396928267,-3,5,8
6,Médio Incompleto,1141,Dirigentes De Partidos Políticos,2002.5699869791667,1,2,1
6,Médio Incompleto,1142,Dirigentes E Administradores De Entidades Patronais E Dos Trabalhadores E De Outros Interesses Sócioeconômicos,2801.887484846444,-7,13,20
6,Médio Incompleto,1143,Dirigentes E Administradores De Entidades Religiosas,1525,0,2,2
6,Médio Incompleto,1144,Dirigentes E Administradores De Organizações Da Sociedade Civil Sem Fins Lucrativos,2547.673299153646,1,2,1
6,Médio Incompleto,1210,Diretores Gerais,1943.352661247889,-63,453,516
6,Médio Incompleto,1221,"Diretores De Produção E Operações Em Empresa Agropecuária, Pesqueira , Aqüícola E Florestal",1988.1146850585938,3,10,7
6,Médio Incompleto,1222,"Diretores De Produção E Operações Em Empresa Da Indústria Extrativa, Transformação E De Serviços De Utilidade Pública",8690.13740123402,-12,5,17
6,Médio Incompleto,1223,Diretores De Operações De Obras Em Empresa De Construção,15887.644403225038,-3,19,22
6,Médio Incompleto,1224,Diretores De Operações Em Empresa Do Comércio,2037.8816412430776,-11,34,45
6,Médio Incompleto,1225,"Diretores De Serviços De Turismo, De Alojamento E De Alimentação",1702.3704959929937,18,54,36
6,Médio Incompleto,1226,"Diretores De Operações De Serviços Em Empresa De Armazenamento, De Transporte E De Telecomunicação",2349.86285659626,-7,28,35
6,Médio Incompleto,1227,Diretores De Operações De Serviços Em Instituição De Intermediação Financeira,5569.424987792969,-6,1,7
6,Médio Incompleto,1231,Diretores Administrativos E Financeiros,2166.09504702146,-103,394,497
6,Médio Incompleto,1232,Diretores De Recursos Humanos E Relações De Trabalho,1770.735610961914,-6,6,12
6,Médio Incompleto,1233,Diretores De Comercialização E Marketing,2727.241052963142,15,101,86
6,Médio Incompleto,1234,Diretores De Suprimentos E Afins,2003.1959109836155,3,10,7
6,Médio Incompleto,1236,Diretores De Tecnologia Da Informação,12408.48937345806,-3,8,11
6,Médio Incompleto,1237,Diretores De Pesquisa E Desenvolvimento,28106,0,1,1
6,Médio Incompleto,1238,Diretores De Manutenção,1875.785870095958,2,24,22
6,Médio Incompleto,1311,"Diretores E Gerentes De Operações Em Empresa De Serviços Pessoais, Sociais E Culturais",2550.728073809585,-27,164,191
6,Médio Incompleto,1312,"Gestores E Especialistas De Operações Em Empresas, Secretarias E Unidades De Serviços De Saúde",2065.0272737379955,-24,87,111
6,Médio Incompleto,1313,Diretores E Gerentes De Instituição De Serviços Educacionais,2767.146073005138,-19,54,73
6,Médio Incompleto,1411,"Gerentes De Produção E Operações Em Empresa Agropecuária, Pesqueira, Aqüícola E Florestal",2653.26952427423,15,1015,1000
6,Médio Incompleto,1412,"Gerentes De Produção E Operações Em Empresa Da Indústria Extrativa, De Transformação E De Serviços De Utilidade Pública",3099.1318237902906,-514,2434,2948
6,Médio Incompleto,1413,Gerentes De Obras Em Empresa De Construção,2912.690706860682,-13,400,413
6,Médio Incompleto,1414,Gerentes De Operações Comerciais E De Assistência Técnica,2207.8459642862044,-2882,11078,13960
6,Médio Incompleto,1415,"Gerentes De Operações De Serviços Em Empresa De Turismo, De Alojamento E Alimentação",2143.2647186897198,-2436,2348,4784
6,Médio Incompleto,1416,"Gerentes De Operações De Serviços Em Empresa De Transporte, De Comunicação E De Logística (Armazenagem E Distribuição)",2514.8576635350673,-460,1124,1584
6,Médio Incompleto,1417,Gerentes De Operações De Serviços Em Instituição De Intermediação Financeira,3558.619127737972,-28,106,134
6,Médio Incompleto,1418,Gerentes Operacionais Da Aviação Civil,2660.575431702629,3,7,4
6,Médio Incompleto,1421,"Gerentes Administrativos, Financeiros, De Riscos E Afins",2792.60316488142,-1791,5467,7258
6,Médio Incompleto,1422,Gerentes De Recursos Humanos E De Relações Do Trabalho,2751.4795395139886,-106,216,322
6,Médio Incompleto,1423,"Gerentes De Comercialização, Marketing E Comunicação",3112.7901470655024,-1976,6706,8682
6,Médio Incompleto,1424,Gerentes De Suprimentos E Afins,2598.2321058311704,-253,371,624
6,Médio Incompleto,1425,Gerentes De Tecnologia Da Informação,5410.196467135088,14,319,305
6,Médio Incompleto,1426,Gerentes De Pesquisa E Desenvolvimento E Afins,5539.353182705966,-16,25,41
6,Médio Incompleto,1427,Gerentes De Manutenção E Afins,3329.1815622649924,-88,301,389
6,Médio Incompleto,2011,Profissionais Da Biotecnologia,2079.4356397545853,5,15,10
6,Médio Incompleto,2012,Profissionais Da Metrologia,1917.030681966146,1,10,9
6,Médio Incompleto,2021,"Engenheiros De Controle E Automação, Engenheiros Mecatrônicos E Afins",3036.5623013329887,2,49,47
6,Médio Incompleto,2030,Pesquisadores Das Ciências Biológicas,2867.82666015625,2,8,6
6,Médio Incompleto,2031,Pesquisadores Das Ciências Naturais E Exatas,4020.8083987113755,23,40,17
6,Médio Incompleto,2032,Pesquisadores De Engenharia E Tecnologia,2050.295101589627,3,8,5
6,Médio Incompleto,2033,Pesquisadores Das Ciências Da Saúde,7346.738846842448,2,6,4
6,Médio Incompleto,2034,Pesquisadores Das Ciências Da Agricultura,3019.701835123698,6,19,13
6,Médio Incompleto,2035,Pesquisadores Das Ciências Sociais E Humanas,2006.1423956008184,1,7,6
6,Médio Incompleto,2041,Peritos Criminais E Judiciais,1100,-1,0,1
6,Médio Incompleto,2111,Profissionais Da Matemática,4997.5983616272415,6,38,32
6,Médio Incompleto,2112,Profissionais De Estatística E Afins,2257.231964111328,2,12,10
6,Médio Incompleto,2122,Engenheiros Em Computação,8143.111910300584,22,64,42
6,Médio Incompleto,2123,Administradores De Tecnologia Da Informação,2822.073858075165,204,498,294
6,Médio Incompleto,2124,Analistas De Tecnologia Da Informação,5716.797666626462,809,3295,2486
6,Médio Incompleto,2131,Físicos,1369.5,-5,1,6
6,Médio Incompleto,2132,Químicos,1930.5816371529581,-3,36,39
6,Médio Incompleto,2134,"Geólogos, Oceanógrafos, Geofísicos E Afins",3249.0024978637693,-2,8,10
6,Médio Incompleto,2140,Engenheiros Ambientais E Afins,2938.6868462057673,-4,20,24
6,Médio Incompleto,2141,Arquitetos E Urbanistas,2148.949863143685,5,42,37
6,Médio Incompleto,2142,Engenheiros Civis E Afins,3163.3348296908434,-66,178,244
6,Médio Incompleto,2143,"Engenheiros Eletricistas, Eletrônicos E Afins",3616.8405802791945,21,142,121
6,Médio Incompleto,2144,Engenheiros Mecânicos E Afins,2163.6781506937327,-6,59,65
6,Médio Incompleto,2145,Engenheiros Químicos E Afins,2737.721082899305,-3,2,5
6,Médio Incompleto,2146,"Engenheiros Metalurgistas, De Materiais E Afins",1299.157498314267,2,19,17
6,Médio Incompleto,2147,Engenheiros De Minas E Afins,5453.280000305176,1,3,2
6,Médio Incompleto,2148,Engenheiros Agrimensores E Engenheiros Cartógrafos,4160,-1,2,3
6,Médio Incompleto,2149,"Engenheiros De Produção, Qualidade, Segurança E Afins",3151.5987093182293,65,162,97
6,Médio Incompleto,2151,Oficiais De Convés E Afins,6321.512759968971,-25,85,110
6,Médio Incompleto,2152,Oficiais De Máquinas Da Marinha Mercante,2854.851262107728,5,20,15
6,Médio Incompleto,2153,Profissionais Da Pilotagem Aeronáutica,3340.0726028070217,3,27,24
6,Médio Incompleto,2211,Biólogos E Afins,1877.2699961942785,6,20,14
6,Médio Incompleto,2212,Biomédicos,2375.6548010253905,0,25,25
6,Médio Incompleto,2221,Engenheiros Agrossilvipecuários,2521.9040062945824,8,48,40
6,Médio Incompleto,2222,Engenheiros De Alimentos E Afins,1462.4442154321914,0,8,8
6,Médio Incompleto,2232,Cirurgiões-Dentistas,3109.98656703404,-11,9,20
6,Médio Incompleto,2233,Veterinários E Zootecnistas,2973.182996562883,-11,27,38
6,Médio Incompleto,2234,Farmacêuticos,2636.6791743532085,-51,168,219
6,Médio Incompleto,2235,Enfermeiros E Afins,3461.762511473558,-107,324,431
6,Médio Incompleto,2236,Fisioterapeutas,2426.1920157324535,33,176,143
6,Médio Incompleto,2237,Nutricionistas,1838.3236901599353,27,351,324
6,Médio Incompleto,2238,Fonoaudiólogos,2938.544911155564,-7,16,23
6,Médio Incompleto,2239,"Terapeutas Ocupacionais, Ortoptistas E Psicomotricistas",1742.0013305664063,-3,6,9
6,Médio Incompleto,2241,Profissionais Da Educação Física,2868.7508937048674,-41,391,432
6,Médio Incompleto,2251,Médicos Clínicos,6463.228356369551,29,160,131
6,Médio Incompleto,2252,Médicos Em Especialidades Cirúrgicas,2738.0105787004745,0,15,15
6,Médio Incompleto,2253,Médicos Em Medicina Diagnóstica E Terapêutica,14065.427734375,-4,1,5
6,Médio Incompleto,2263,"Profissionais Das Terapias Criativas,Equoterápicas E Naturológicas",1811.3133178710937,-2,3,5
6,Médio Incompleto,2311,Professores De Nível Superior Na Educação Infantil,5291.291935615707,-41,175,216
6,Médio Incompleto,2312,Professores De Nível Superior Do Ensino Fundamental (Primeira A Quarta Séries),6861.953599066017,-100,271,371
6,Médio Incompleto,2313,Professores De Nível Superior No Ensino Fundamental De Quinta A Oitava Série,2166.4505754055454,16,130,114
6,Médio Incompleto,2321,Professores Do Ensino Médio,1393.451945792433,-26,104,130
6,Médio Incompleto,2331,Professores Do Ensino Profissional,1698.4160429454982,-6,16,22
6,Médio Incompleto,2332,Instrutores De Ensino Profissional,1445.0060008518217,-797,1233,2030
6,Médio Incompleto,2341,"Professores De Matemática, Estatística E Informática Do Ensino Superior",1070.8400152921677,-2,7,9
6,Médio Incompleto,2342,"Professores De Ciências Físicas, Químicas E Afins Do Ensino Superior",2411,1,1,0
6,Médio Incompleto,2343,"Professores De Arquitetura E Urbanismo, Engenharia, Geofísica E Geologia Do Ensino Superior",1536.6522182888455,-3,2,5
6,Médio Incompleto,2344,Professores De Ciências Biológicas E Da Saúde Do Ensino Superior,2170.048872142368,-9,26,35
6,Médio Incompleto,2345,Professores Na Área De Formação Pedagógica Do Ensino Superior,2169.0362675131946,-26,22,48
6,Médio Incompleto,2346,Professores Nas Áreas De Língua E Literatura Do Ensino Superior,1538.7612192712213,64,258,194
6,Médio Incompleto,2347,Professores De Ciências Humanas Do Ensino Superior,1311.6666666666667,-1,1,2
6,Médio Incompleto,2348,"Professores De Ciências Econômicas, Administrativas E Contábeis Do Ensino Superior",1669.1921732731355,0,8,8
6,Médio Incompleto,2349,Professores De Artes Do Ensino Superior,2354.0875044928657,2,13,11
6,Médio Incompleto,2392,Professores De Educação Especial,1757.298666467422,-7,22,29
6,Médio Incompleto,2394,"Programadores, Avaliadores E Orientadores De Ensino",2052.3274153108837,-17,657,674
6,Médio Incompleto,2410,Advogados,3400.3030784769,-2,151,153
6,Médio Incompleto,2412,Procuradores E Advogados Públicos,1231,2,3,1
6,Médio Incompleto,2413,Tabeliães E Registradores,1947.3428457799848,-21,31,52
6,Médio Incompleto,2422,Membros Do Ministério Público,1177,1,1,0
6,Médio Incompleto,2424,Defensores Públicos E Procuradores Da Assistência Judiciária,1739.606689453125,-1,1,2
6,Médio Incompleto,2429,Profissionais Da Inteligência,3500,0,1,1
6,Médio Incompleto,2511,Profissionais Em Pesquisa E Análise Antropológica Sociológica,112219.25166829428,2,4,2
6,Médio Incompleto,2512,Economistas,2786.303276078191,24,159,135
6,Médio Incompleto,2513,Profissionais Em Pesquisa E Análise Geográfica,5436.47998046875,1,1,0
6,Médio Incompleto,2515,Psicólogos E Psicanalistas,2512.6096710208835,-4,47,51
6,Médio Incompleto,2516,Assistentes Sociais E Economistas Domésticos,2144.017639612269,-2,68,70
6,Médio Incompleto,2521,Administradores,2351.1873645871633,136,2027,1891
6,Médio Incompleto,2522,Contadores E Afins,2752.8472538540877,-107,507,614
6,Médio Incompleto,2523,Secretárias(Os) Executivas(Os) E Afins,1449.1125932253285,315,4203,3888
6,Médio Incompleto,2524,Profissionais De Recursos Humanos,2225.1986895282744,44,647,603
6,Médio Incompleto,2525,Profissionais De Administração Ecônomico-Financeira,2417.135096583551,-5,722,727
6,Médio Incompleto,2526,Profissionais Da Administração Dos Serviços De Segurança,2423.1418547453704,-6,24,30
6,Médio Incompleto,2527,"Profissionais De Planejamento, Programação E Controles Logisticos",2194.2925349803063,44,464,420
6,Médio Incompleto,2531,Profissionais De Publicidade,2213.9280824423545,135,923,788
6,Médio Incompleto,2532,Profissionais De Comercializacão E Consultoria De Serviços Bancários,2842.6047915791564,-1,1056,1057
6,Médio Incompleto,2533,"Corretores De Valores, Ativos Financeiros, Mercadorias E Derivativos",1528.4982285719652,-4,63,67
6,Médio Incompleto,2534,Profissionais De Mídias Digitais E Afins,2749.517188646362,179,388,209
6,Médio Incompleto,2541,Auditores Fiscais E Técnicos Da Receita Federal,1436.7724914550781,2,4,2
6,Médio Incompleto,2543,Auditores Fiscais Do Trabalho,1892.6868313879293,39,1028,989
6,Médio Incompleto,2544,Fiscais De Tributos Estaduais E Municipais,1753.5034057617188,-6,15,21
6,Médio Incompleto,2545,Profissionais Da Fiscalização De Atividades Urbanas,1642.9202467395414,14,69,55
6,Médio Incompleto,2611,Profissionais Do Jornalismo,1957.8399953554072,-72,376,448
6,Médio Incompleto,2612,Profissionais Da Informação,1882.195000716308,22,190,168
6,Médio Incompleto,2613,Arquivistas E Museólogos,1153.350591997267,11,287,276
6,Médio Incompleto,2614,"Filólogos,Tradutores ,Intérpretes E Afins",3613.3516395362885,-3,33,36
6,Médio Incompleto,2615,Profissionais Da Escrita,3329.939848841235,3,32,29
6,Médio Incompleto,2616,Editores,1825.9002027338202,15,56,41
6,Médio Incompleto,2617,"Locutores, Comentaristas E Repórteres De Mídias Audiovisuais",2403.8598051758518,-112,384,496
6,Médio Incompleto,2618,Fotógrafos Profissionais,2023.7380159514314,-17,303,320
6,Médio Incompleto,2619,Assistentes De Direção (Tv) E Continuístas,1724.185986328125,1,9,8
6,Médio Incompleto,2621,Produtores Artísticos E Culturais,1666.4547031314632,-5,124,129
6,Médio Incompleto,2622,Diretores De Espetáculos E Afins,4354.887506394159,-10,17,27
6,Médio Incompleto,2623,Cenógrafos,2886.078777588273,-9,33,42
6,Médio Incompleto,2624,"Artistas Visuais,Desenhistas Industriais E Conservadores-Restauradores De Bens Culturais",2563.9137769999193,303,1366,1063
6,Médio Incompleto,2625,Atores,3159.471672233898,-135,41,176
6,Médio Incompleto,2626,"Músicos Compositores, Arranjadores, Regentes E Musicólogos",1470.8341063108899,-29,106,135
6,Médio Incompleto,2627,Músicos Intérpretes,1596.8125356963185,-30,307,337
6,Médio Incompleto,2628,Artistas Da Dança (Exceto Dança Tradicional E Popular),1562.6479171087205,-4,88,92
6,Médio Incompleto,2629,Designer De Interiores De Nível Superior,2177.788908781829,-1,13,14
6,Médio Incompleto,2631,"Ministros De Culto, Missionários, Teólogos E Profissionais Assemelhados",2065.6438332141283,-9,36,45
6,Médio Incompleto,2711,Chefes De Cozinha E Afins,2237.3546842524675,-442,1624,2066
6,Médio Incompleto,3001,Técnicos Em Mecatrônica,1264.5431602664166,231,820,589
6,Médio Incompleto,3003,Técnicos Em Eletromecânica,1581.5103702205236,563,1698,1135
6,Médio Incompleto,3011,Técnicos De Laboratório Industrial,2990.4785118201544,-12,2256,2268
6,Médio Incompleto,3012,Técnicos De Apoio À Bioengenharia,1280,1,1,0
6,Médio Incompleto,3111,Técnicos Químicos,2036.188552765205,-11,352,363
6,Médio Incompleto,3112,"Técnicos De Produção De Indústrias Químicas, Petroquímicas, Refino De Petróleo, Gás E Afins",2390.7349853515625,0,8,8
6,Médio Incompleto,3113,"Técnicos Em Materiais, Produtos Cerâmicos E Vidros",5540.740593319848,16,50,34
6,Médio Incompleto,3114,Técnicos Em Fabricação De Produtos Plásticos E De Borracha,1820.774039717855,41,684,643
6,Médio Incompleto,3115,"Técnicos Em Controle Ambiental, Utilidades E Tratamento De Efluentes",3268.707249474426,8,356,348
6,Médio Incompleto,3116,Técnicos Têxteis,2017.9088262683003,-19,68,87
6,Médio Incompleto,3117,Coloristas,2245.129016829056,-107,3708,3815
6,Médio Incompleto,3121,Técnicos Em Construção Civil (Edificações),2421.6152464930333,114,1719,1605
6,Médio Incompleto,3122,Técnicos Em Construção Civil (Obras De Infraestrutura),3163.7394229589536,20,528,508
6,Médio Incompleto,3123,Técnicos Em Geomática,1946.6423408800356,191,3680,3489
6,Médio Incompleto,3131,Técnicos Em Eletricidade E Eletrotécnica,3618.761398082737,70,4409,4339
6,Médio Incompleto,3132,Técnicos Em Eletrônica,1858.4971420225788,547,7260,6713
6,Médio Incompleto,3133,Técnicos Em Telecomunicações,1608.1120090643003,408,3587,3179
6,Médio Incompleto,3134,Técnicos Em Calibração E Instrumentação,2110.3179563800713,-50,881,931
6,Médio Incompleto,3135,Técnicos Em Fotônica,1579.9572649554068,-31,546,577
6,Médio Incompleto,3141,"Técnicos Mecânicos Na Fabricação E Montagem De Máquinas, Sistemas E Instrumentos",3558.093952761012,572,5378,4806
6,Médio Incompleto,3142,Técnicos Mecânicos (Ferramentas),1746.606020623149,-12,257,269
6,Médio Incompleto,3143,Técnicos Em Mecânica Veicular,2631.463186336831,9,304,295
6,Médio Incompleto,3144,"Técnicos Mecânicos Na Manutenção De Máquinas, Sistemas E Instrumentos",1808.326908290745,5,1463,1458
6,Médio Incompleto,3146,Técnicos Em Metalurgia (Estruturas Metálicas),2462.192082126922,13,328,315
6,Médio Incompleto,3147,Técnicos Em Siderurgia,19514.4263274209,-14,83,97
6,Médio Incompleto,3148,Especialistas Em Inspeções Industriais,4135.954876660196,21,64,43
6,Médio Incompleto,3161,Técnicos Em Geologia,1794.3756093678458,15,89,74
6,Médio Incompleto,3163,Técnicos Em Mineração,3537.1826139441814,2,61,59
6,Médio Incompleto,3171,Técnicos De Desenvolvimento De Sistemas E Aplicações,3969.671662555565,962,2968,2006
6,Médio Incompleto,3172,Técnicos De Suporte E Monitoração Ao Usuário De Tecnologia Da Informação.,1905.8640160664272,1119,5947,4828
6,Médio Incompleto,3180,"Desenhistas Técnicos, Em Geral",1608.3104241124413,69,515,446
6,Médio Incompleto,3181,Desenhistas Técnicos Da Construção Civil E Arquitetura,1789.5042257679988,-18,162,180
6,Médio Incompleto,3182,Desenhistas Técnicos Da Mecânica,831.9706052836806,329,1481,1152
6,Médio Incompleto,3183,"Desenhistas Técnicos Em Eletricidade, Eletrônica, Eletromecânica, Calefação, Ventilação E Refrigeração",1429.717455694775,9,78,69
6,Médio Incompleto,3184,Desenhistas Técnicos De Produtos E Serviços Diversos,1639.397123096699,105,682,577
6,Médio Incompleto,3185,Desenhistas Projetistas De Construção Civil E Arquitetura,2601.4343212325853,47,312,265
6,Médio Incompleto,3186,Desenhistas Projetistas Da Mecânica,2419.276633703404,4,276,272
6,Médio Incompleto,3187,Desenhistas Projetistas Da Eletrônica,7948.851091628779,18,85,67
6,Médio Incompleto,3188,Desenhistas Projetistas E Modelistas De Produtos E Serviços Diversos,2855.3656970541815,-21,779,800
6,Médio Incompleto,3191,Técnicos Do Vestuário,1510.3929674359767,-29,75,104
6,Médio Incompleto,3192,Técnicos Do Mobiliário E Afins,1704.008389352382,-7,40,47
6,Médio Incompleto,3201,Técnicos Em Biologia,1071.957322038923,-7,13,20
6,Médio Incompleto,3211,Técnicos Agrícolas,1554.6529851539506,17,1183,1166
6,Médio Incompleto,3212,Técnicos Florestais,1768.9778567364847,18,510,492
6,Médio Incompleto,3213,Técnicos Em Aqüicultura,1041.8679799191627,-4,108,112
6,Médio Incompleto,3221,Tecnólogos E Técnicos Em Terapias Complementares E Estéticas,1613.5075167867415,-182,600,782
6,Médio Incompleto,3222,Técnicos E Auxiliares De Enfermagem,1786.0399994072184,-551,4251,4802
6,Médio Incompleto,3223,Técnicos Em Óptica E Optometria,1781.5420213896653,-6,113,119
6,Médio Incompleto,3224,Técnicos De Odontologia,1501.046798300367,57,2879,2822
6,Médio Incompleto,3225,Técnicos Em Próteses Ortopédicas,2098.805560025302,-22,33,55
6,Médio Incompleto,3226,Técnicos De Imobilizações Ortopédicas,1690.9465118892608,-22,21,43
6,Médio Incompleto,3231,Técnicos Em Pecuária,2019.718365363355,10,58,48
6,Médio Incompleto,3241,Tecnólogos E Técnicos Em Métodos De Diagnósticos E Terapêutica,1597.330593190991,-63,126,189
6,Médio Incompleto,3242,Técnicos De Laboratórios De Saúde E Bancos De Sangue,1826.5800315419738,-53,189,242
6,Médio Incompleto,3250,"Enólogos, Perfumistas E Aromistas",2347.9179959496573,12,244,232
6,Médio Incompleto,3251,Técnico Em Farmácia E Em Manipulação Farmacêutica,1631.740919354741,28,480,452
6,Médio Incompleto,3252,"Técnicos Em Produção, Conservação  E De Qualidade De Alimentos",1455.3007144102307,-31,1183,1214
6,Médio Incompleto,3253,Técnicos De Apoio À Biotecnologia,1503.5712509155273,2,6,4
6,Médio Incompleto,3281,Técnicos Em Necrópsia E Taxidermistas,1528.7560471205684,-8,10,18
6,Médio Incompleto,3311,Professores De Nível Médio Na Educação Infantil,1524.0863590471272,350,4725,4375
6,Médio Incompleto,3312,Professores De Nível Médio No Ensino Fundamental,1742.1447864098627,21,209,188
6,Médio Incompleto,3313,Professores De Nível Médio No Ensino Profissionalizante,1312.7039654944554,-1,63,64
6,Médio Incompleto,3321,Professores Leigos No Ensino Fundamental,1168.8219556051588,-9,91,100
6,Médio Incompleto,3322,Professores Práticos No Ensino Profissionalizante,1435.3052901344738,-31,28,59
6,Médio Incompleto,3331,Instrutores E Professores De Cursos Livres,2441.4777806537554,4,2372,2368
6,Médio Incompleto,3341,Inspetores De Alunos E Afins,1577.9037874146504,417,5530,5113
6,Médio Incompleto,3411,"Pilotos De Aviação Comercial, Mecânicos De Vôo E Afins",3066.0412370954245,0,47,47
6,Médio Incompleto,3412,"Técnicos Marítimos, Fluviários E Pescadores De Convés",3296.8655790711878,-40,493,533
6,Médio Incompleto,3413,Técnicos Marítimos E Fluviários De Máquinas,1871.620949216685,-25,270,295
6,Médio Incompleto,3421,Especialistas Em Logística De Transportes,1832.1971282824863,140,5332,5192
6,Médio Incompleto,3422,Despachantes Aduaneiros,1889.4506506952866,-53,488,541
6,Médio Incompleto,3423,Técnicos Em Transportes Rodoviários,2697.990799048748,-716,1747,2463
6,Médio Incompleto,3424,Técnicos Em Transportes Metroferroviários,1766.020462517149,-69,218,287
6,Médio Incompleto,3425,Técnicos Em Transportes Aéreos,1930.2491557722306,-3,294,297
6,Médio Incompleto,3426,Técnicos Em Transportes Por Vias Navegáveis E Operações Portuárias,2450.282296796926,-41,41,82
6,Médio Incompleto,3511,Técnicos Em Contabilidade,2343.0983191467426,-26,106,132
6,Médio Incompleto,3513,Técnicos Em Administração,2416.130804054541,157,1012,855
6,Médio Incompleto,3514,Serventuários Da Justiça E Afins,2124.776628110632,-50,876,926
6,Médio Incompleto,3515,"Técnicos Em Secretariado, Taquígrafos E Estenotipistas",2470.521272587941,-113,1636,1749
6,Médio Incompleto,3516,Técnicos Em Segurança Do Trabalho,2843.7265151349325,34,1915,1881
6,Médio Incompleto,3517,Técnicos De Seguros E Afins,1831.3584109128644,-52,1053,1105
6,Médio Incompleto,3518,Agentes De Investigação E Identificação,1345.1140969016335,2,12,10
6,Médio Incompleto,3519,Técnicos Da Inteligência,2864.7524658203124,3,5,2
6,Médio Incompleto,3522,Agentes Da Saúde E Do Meio Ambiente,1583.9999920261798,-34,644,678
6,Médio Incompleto,3523,Agentes  Fiscais Metrológicos E De Qualidade,2091.166814190658,-37,236,273
6,Médio Incompleto,3524,Profissionais De Direitos Autorais E De Avaliacão De Produtos Dos Meios De Comunicação,3031.219447877672,-2,13,15
6,Médio Incompleto,3532,Técnicos Em Operações E Serviços Bancários,2445.512266951874,-77,51,128
6,Médio Incompleto,3541,Especialistas Em Promoção De Produtos E Vendas,1523.0966362177476,2397,33342,30945
6,Médio Incompleto,3542,Compradores,3540.7020668500463,-352,1228,1580
6,Médio Incompleto,3543,Analistas De Comércio Exterior,2720.5851987276465,9,91,82
6,Médio Incompleto,3544,Leiloeiros E Avaliadores,2235.596371985209,-8,149,157
6,Médio Incompleto,3545,Corretores De Seguros,1439.0837478637695,0,48,48
6,Médio Incompleto,3546,Corretores De Imóveis E De Grãos,1648.6612156918175,-4,93,97
6,Médio Incompleto,3547,Representantes Comerciais Autônomos,1488.1319311725758,-22,170,192
6,Médio Incompleto,3548,Técnicos Em Serviços De Turismo E Organização De Eventos,1727.8861039264332,70,1024,954
6,Médio Incompleto,3711,Técnicos Em Biblioteconomia,1504.3912845203713,-44,157,201
6,Médio Incompleto,3712,Técnicos Em Museologia E Afins,810,8,8,0
6,Médio Incompleto,3713,Técnicos Em Artes Gráficas,1481.2866395419746,-1,131,132
6,Médio Incompleto,3714,Recreadores,3127.231941315774,527,4914,4387
6,Médio Incompleto,3721,Captadores De Imagens Em Movimento,2217.3327199100554,-121,464,585
6,Médio Incompleto,3722,Operadores De Rede De Teleprocessamento E Afins,1445.4733604119801,99,500,401
6,Médio Incompleto,3731,Técnicos De Operação De Registros Sonoro/Audiovisuais,2265.0904106896865,-59,563,622
6,Médio Incompleto,3732,Supervisores Operacionais E Técnicos Em Mídias Audiovisuais,2757.4548279908327,-73,63,136
6,Médio Incompleto,3741,Técnicos Em Áudio,1595.770950545931,-71,1128,1199
6,Médio Incompleto,3742,Técnicos Em Cenografia,2833.3936827352422,-37,117,154
6,Médio Incompleto,3743,Técnicos Em Operação De Aparelhos De Projeção,1960.3204394959566,-14,48,62
6,Médio Incompleto,3744,"Técnicos Em Montagem, Edição E Finalização De Mídia Audiovisual",2298.504777122453,120,1290,1170
6,Médio Incompleto,3751,"Designers De Interiores, De Vitrines E Visual Merchandiser E Afins (Nível Médio)",1610.917870712102,-86,729,815
6,Médio Incompleto,3761,Dançarinos Tradicionais E Populares,1550.4802504319412,-9,11,20
6,Médio Incompleto,3762,Artistas De Circo (Circenses),1734.7288700001711,-7,38,45
6,Médio Incompleto,3763,"Apresentadores De Eventos, Programas E Espetáculos",1967.3201680843883,48,182,134
6,Médio Incompleto,3764,Modelos,1407.928537552445,-1,22,23
6,Médio Incompleto,3771,Atletas Profissionais,3429.249668894835,620,5100,4480
6,Médio Incompleto,3772,Árbitros Desportivos,1756.5315817808494,5,19,14
6,Médio Incompleto,3911,"Planejadores, Programadores E Controladores De Produção E Manutenção",2089.4559692257276,287,11973,11686
6,Médio Incompleto,3912,Técnicos De Controle Da Produção,2158.944437636106,-143,12226,12369
6,Médio Incompleto,3951,Técnicos De Apoio Em Pesquisa E Desenvolvimento,1622.7818968993406,-50,487,537
6,Médio Incompleto,4101,Supervisores Administrativos,3076.1285733653863,-3791,6649,10440
6,Médio Incompleto,4102,"Supervisores De Serviços Financeiros, De Câmbio E De Controle",2262.641052449438,-868,2252,3120
6,Médio Incompleto,4110,"Agentes, Assistentes E Auxiliares Administrativos",1422.7721660333304,105165,645224,540059
6,Médio Incompleto,4121,Operadores De Equipamentos De Entrada E Transmissão De Dados,1681.4231764911924,42,1420,1378
6,Médio Incompleto,4122,Contínuos,2002.9202524235875,-183,29606,29789
6,Médio Incompleto,4131,Auxiliares De Contabilidade,1899.4362783493136,803,7998,7195
6,Médio Incompleto,4132,Escriturários De Serviços Bancários,1478.3379018966564,-1032,13613,14645
6,Médio Incompleto,4141,Almoxarifes E Armazenistas,1717.742427234316,32341,226147,193806
6,Médio Incompleto,4142,Apontadores E Conferentes,1292658.9545343115,-2674,25752,28426
6,Médio Incompleto,4151,"Auxiliares De Serviços De Documentação, Informação E Pesquisa",1383.1124875049004,15,2251,2236
6,Médio Incompleto,4152,"Trabalhadores Nos Serviços De Classificação E Entregas De Correspondências, Encomendas E Publicações",1671.8384828730784,-123,1595,1718
6,Médio Incompleto,4153,Trabalhadores Em Registros E Informações Em Saúde,1859,0,1,1
6,Médio Incompleto,4201,Supervisores De Atendimento Ao Público E De Pesquisa,1997.0693661645932,-1110,1136,2246
6,Médio Incompleto,4211,Caixas E Bilheteiros (Exceto Caixa De Banco),1422.5143699141292,5695,152861,147166
6,Médio Incompleto,4212,Coletadores De Apostas E De Jogos,1325.1116221858017,-193,1332,1525
6,Médio Incompleto,4213,Cobradores E Afins,2881.316191895619,647,10583,9936
6,Médio Incompleto,4221,Recepcionistas,1689.7662052464682,3166,54339,51173
6,Médio Incompleto,4222,Operadores De Telefonia,1379.4050714533817,-313,1923,2236
6,Médio Incompleto,4223,Operadores De Telemarketing E Afins,1428.3530702293094,3349,32868,29519
6,Médio Incompleto,4231,Despachantes Documentalistas E Afins,2372.03368853452,-199,607,806
6,Médio Incompleto,4241,Entrevistadores E Recenseadores,1365.8128110024334,5,729,724
6,Médio Incompleto,4242,Aplicadores De Provas E Afins,1569.3011081271702,6,10,4
6,Médio Incompleto,5101,"Supervisores Dos Serviços De Transporte, Turismo, Hotelaria E Administração De Edifícios",3053.3941875956207,-925,1771,2696
6,Médio Incompleto,5102,Supervisores De Lavanderia,1891.5417836782094,-171,192,363
6,Médio Incompleto,5103,"Supervisores Dos Serviços De Proteção, Segurança E Outros",2313.9504886571613,-244,331,575
6,Médio Incompleto,5111,Trabalhadores De Segurança E Atendimento Aos Usuários Nos Transportes,1364.6542637370953,3,503,500
6,Médio Incompleto,5112,Fiscais E Cobradores Dos Transportes Coletivos,1600.138413456311,-5360,5881,11241
6,Médio Incompleto,5114,Guias De Turismo,1114.2861085445322,23,176,153
6,Médio Incompleto,5115,Condutores De Turismo,1406.5954214242788,18,62,44
6,Médio Incompleto,5121,Trabalhadores Dos Serviços Domésticos Em Geral,1503.7922612361044,692,4205,3513
6,Médio Incompleto,5131,Mordomos E Governantas,1555.0749116033846,-50,873,923
6,Médio Incompleto,5132,Cozinheiros,1565.7043472004864,-3938,76634,80572
6,Médio Incompleto,5133,"Camareiros, Roupeiros E Afins",1559.0959798938204,-18,23685,23703
6,Médio Incompleto,5134,"Trabalhadores No Atendimento Em Estabelecimentos De Serviços De Alimentação, Bebidas E Hotelaria",1845.494767539409,12381,233937,221556
6,Médio Incompleto,5135,Trabalhadores Auxiliares Nos Serviços De Alimentação,1559.446873957093,8279,129017,120738
6,Médio Incompleto,5136,"Churrasqueiros, Pizzaiolos E Sushimen",1724.9079704606236,-251,11051,11302
6,Médio Incompleto,5141,Trabalhadores Nos Serviços De Administração De Edifícios,1557.1907863980477,8,35350,35342
6,Médio Incompleto,5142,"Trabalhadores Nos Serviços De Coleta De Resíduos, De Limpeza E Conservação De Áreas Públicas",1512.0459446580644,6278,81297,75019
6,Médio Incompleto,5143,Trabalhadores Nos  Serviços De Manutenção De Edificações,1834.0303078702455,40387,443822,403435
6,Médio Incompleto,5151,Trabalhadores Em Serviços De Promoção E Apoio À Saúde,1732.621442749967,151,2860,2709
6,Médio Incompleto,5152,Auxiliares De Laboratório Da Saúde,1575.2943146904029,282,4466,4184
6,Médio Incompleto,5153,"Trabalhadores De Atenção, Defesa E Proteção A Pessoas Em Situação De Risco E Adolescentes Em Conflito Com A Lei",3784.835926342252,-16,1704,1720
6,Médio Incompleto,5161,Trabalhadores Nos Serviços De Embelezamento E Higiene,1737.108711987803,-980,1728,2708
6,Médio Incompleto,5162,"Cuidadores De Crianças, Jovens, Adultos E Idosos",1862.395168621376,716,7396,6680
6,Médio Incompleto,5163,"Tintureiros, Lavadeiros E Afins, A Máquina",1526.5471210339101,473,17658,17185
6,Médio Incompleto,5164,"Lavadores E Passadores De Roupa, A Mão",2224.083915205529,-121,1086,1207
6,Médio Incompleto,5165,Trabalhadores Dos Serviços Funerários,1483.8819813754315,42,1398,1356
6,Médio Incompleto,5166,Trabalhadores Auxiliares Dos Serviços Funerários,1593.9068777678212,142,764,622
6,Médio Incompleto,5167,Astrólogos E Numerólogos,0,-2,0,2
6,Médio Incompleto,5169,Trabalhadores Nos Serviços De Arte Corporal,1400,0,1,1
6,Médio Incompleto,5171,"Bombeiros, Salva-Vidas E Afins",1798.5634585292123,44,1794,1750
6,Médio Incompleto,5172,"Policiais, Guardas-Civis Municipais E Agentes De Trânsito",7294.132211272914,-96,828,924
6,Médio Incompleto,5173,Vigilantes E Guardas De Segurança,1857.3482223329988,-4500,29313,33813
6,Médio Incompleto,5174,"Porteiros, Vigias E Afins",1696.955943773971,-2391,90593,92984
6,Médio Incompleto,5191,Motociclistas E Ciclistas De Entregas Rápidas,1524.9834059063114,-169,25966,26135
6,Médio Incompleto,5192,Trabalhadores Da Coleta E Seleção De Material Reciclável,1775.0191062267704,527,4953,4426
6,Médio Incompleto,5193,"Trabalhadores De Serviços Veterinários, De Higiene E Estética De Animais Domésticos",1497.4476264494174,238,5596,5358
6,Médio Incompleto,5199,Outros Trabalhadores Dos Serviços,1545.393071832013,1499,30330,28831
6,Médio Incompleto,5201,Supervisores De Vendas E De Prestação De Serviços,2505.5764933133933,-1594,2443,4037
6,Médio Incompleto,5211,Operadores Do Comércio Em Lojas E Mercados,1505.9305423034803,48018,748014,699996
6,Médio Incompleto,5231,Instaladores De Produtos E Acessórios,1630.2532470961166,56,3666,3610
6,Médio Incompleto,5241,Vendedores Em Domicílio,1361.1736612049142,-332,6284,6616
6,Médio Incompleto,5242,"Vendedores Em Bancas, Quiosques E Barracas",1306.2139958342057,-97,564,661
6,Médio Incompleto,5243,Vendedores Ambulantes,1467.0198619368189,-61,518,579
6,Médio Incompleto,6110,Produtores Agropecuários Em Geral,1466.0367973419727,69,573,504
6,Médio Incompleto,6120,Produtores Agrícolas Polivalentes,1416.441962650062,111,578,467
6,Médio Incompleto,6121,Produtores Agrícolas Na Cultura De Gramíneas,1432.615671762917,23,181,158
6,Médio Incompleto,6122,Produtores Agrícolas Na Cultura De Plantas Fibrosas,1249.1666666666665,-3,1,4
6,Médio Incompleto,6123,Produtores Agrícolas Na Olericultura,1270.9629852244918,-1,143,144
6,Médio Incompleto,6124,Produtores Agrícolas No Cultivo De Flores E Plantas Ornamentais,1761.3972850024215,3,105,102
6,Médio Incompleto,6125,Produtores Agrícolas Na Fruticultura,1251.221713538459,29,247,218
6,Médio Incompleto,6126,Produtores Agrícolas Na Cultura De Plantas Estimulantes,2550,2,3,1
6,Médio Incompleto,6127,Produtores Agrícolas Na Cultura De Plantas Oleaginosas,1429.4166666666667,1,11,10
6,Médio Incompleto,6128,Produtores De Especiarias E De Plantas Aromáticas E Medicinais,1656.5342320033483,3,6,3
6,Médio Incompleto,6130,Produtores Em Pecuária Polivalente,1403.2055614943297,-2,79,81
6,Médio Incompleto,6131,Produtores Em Pecuária De Animais De Grande Porte,1444.0168297708178,-10,188,198
6,Médio Incompleto,6132,Produtores Em Pecuária De Animais De Médio Porte,2670.6529219905256,22,154,132
6,Médio Incompleto,6133,Produtores Da Avicultura E Cunicultura,1585.9903013596704,115,906,791
6,Médio Incompleto,6134,Produtores De Animais E Insetos Úteis,1501.798820957993,9,26,17
6,Médio Incompleto,6201,Supervisores Na Exploração Agropecuária,2487.2177695631563,-122,4347,4469
6,Médio Incompleto,6210,Trabalhadores Agropecuários Em Geral,1591.2019274269344,7643,94270,86627
6,Médio Incompleto,6220,Trabalhadores De Apoio À Agricultura,2286.6630942422094,10528,105896,95368
6,Médio Incompleto,6221,Trabalhadores Agrícolas Na Cultura De Gramíneas,2570.5492281237457,3389,48104,44715
6,Médio Incompleto,6222,Trabalhadores Agrícolas Na Cultura De Plantas Fibrosas,2249.7157090710875,30,488,458
6,Médio Incompleto,6223,Trabalhadores Agrícolas Na Olericultura,1332.1876876467286,215,4708,4493
6,Médio Incompleto,6224,Trabalhadores Agrícolas No Cultivo De Flores E Plantas Ornamentais,1400.0984476926951,141,4275,4134
6,Médio Incompleto,6225,Trabalhadores Agrícolas Na Fruticultura,2704.4446720348697,3206,58333,55127
6,Médio Incompleto,6226,Trabalhadores Agrícolas Nas Culturas De Plantas Estimulantes,1221.2599858285212,270,13113,12843
6,Médio Incompleto,6227,Trabalhadores Agrícolas Na Cultura De Plantas Oleaginosas,1564.546717409969,904,4124,3220
6,Médio Incompleto,6228,Trabalhadores Agrícolas Da Cultura De Especiarias E De Plantas Aromáticas E Medicinais,1329.9752114528505,22,248,226
6,Médio Incompleto,6230,Tratadores Polivalentes De Animais,1838.3759717130597,993,9449,8456
6,Médio Incompleto,6231,Trabalhadores Na Pecuária De Animais De Grande Porte,1851.6640566072947,1970,26276,24306
6,Médio Incompleto,6232,Trabalhadores Na Pecuária De Animais De Médio Porte,1399.368432400147,576,6151,5575
6,Médio Incompleto,6233,Trabalhadores Na Avicultura E Cunicultura,1405.3236560372072,1657,23048,21391
6,Médio Incompleto,6234,Trabalhadores Na Criação De Insetos E Animais Úteis,1437.59017180015,-20,153,173
6,Médio Incompleto,6301,Supervisores Na Área Florestal E Aqüicultura,2340.523267806112,-26,519,545
6,Médio Incompleto,6310,Pescadores Polivalentes,1421.5507654506139,6,82,76
6,Médio Incompleto,6311,Pescadores Profissionais Artesanais De Água Doce,1286.6730254202178,5,19,14
6,Médio Incompleto,6312,Pescadores De Água Costeira E Alto Mar,1566.6739010591423,-84,1631,1715
6,Médio Incompleto,6313,Criadores De Animais Aquáticos,1630.9817054561877,175,1430,1255
6,Médio Incompleto,6314,Trabalhadores De Apoio À Pesca,1396.5428128783956,21,90,69
6,Médio Incompleto,6320,Trabalhadores Florestais Polivalentes,1952.443930349369,233,897,664
6,Médio Incompleto,6321,Extrativistas E Reflorestadores De Espécies Produtoras De Madeira,1494.5953883032937,1895,20656,18761
6,Médio Incompleto,6322,Extrativistas Florestais De Espécies Produtoras De Gomas E Resinas,1390.9940575682824,-42,2210,2252
6,Médio Incompleto,6323,"Extrativistas Florestais De Espécies Produtoras De Fibras, Ceras E Óleos",3493.4210651056496,44,426,382
6,Médio Incompleto,6324,Extrativistas Florestais De Espécies Produtoras De Alimentos Silvestres,1129.369880559524,13,254,241
6,Médio Incompleto,6325,"Extrativistas Florestais De Espécies Produtoras De Substâncias Aromáticas, Medicinais E Tóxicas",1373.4445128935963,-16,98,114
6,Médio Incompleto,6326,Carvoejadores,1398.4523979027788,275,3607,3332
6,Médio Incompleto,6410,Trabalhadores Da Mecanização Agrícola,4665.739626407927,5453,60597,55144
6,Médio Incompleto,6420,Trabalhadores Da Mecanização Florestal,1947.8657191076734,383,3518,3135
6,Médio Incompleto,6430,Trabalhadores Da Irrigação E Drenagem,1705.6369203805757,174,1480,1306
6,Médio Incompleto,7101,Supervisores Da Extração Mineral,3712.060339408136,-10,251,261
6,Médio Incompleto,7102,Supervisores Da Construção Civil,3115.444499847904,51,15171,15120
6,Médio Incompleto,7111,Trabalhadores Da Extração De Minerais Sólidos,2049.495107013763,526,3507,2981
6,Médio Incompleto,7112,Trabalhadores De Extração De Minerais Sólidos (Operadores De Máquinas),3615.5742446473537,-3,5261,5264
6,Médio Incompleto,7113,Trabalhadores Da Extração De Minerais Líquidos E Gasosos,2115.6692511386154,208,1689,1481
6,Médio Incompleto,7114,Garimpeiros E Operadores De Salinas,1274.469959253348,76,204,128
6,Médio Incompleto,7121,Trabalhadores De Beneficiamento De Minérios,1717.4851039436398,192,1669,1477
6,Médio Incompleto,7122,Trabalhadores De Beneficiamento De Pedras Ornamentais,1899.1945047656047,245,5295,5050
6,Médio Incompleto,7151,Trabalhadores Na Operação De Máquinas De Terraplenagem E Fundações,2666.7760851747516,2199,34189,31990
6,Médio Incompleto,7152,Trabalhadores De Estruturas De Alvenaria,2383.0767487404414,6585,120029,113444
6,Médio Incompleto,7153,Montadores De Estruturas De Concreto Armado,2309.1734909505117,1341,24603,23262
6,Médio Incompleto,7154,Trabalhadores Na Operação De Máquinas De Concreto Usinado E Afins,2142.083616562478,13,4118,4105
6,Médio Incompleto,7155,"Trabalhadores De Montagem De Estruturas De Madeira, Metal E Compósitos Em Obras Civis",2360.226400704353,2532,51919,49387
6,Médio Incompleto,7156,Trabalhadores De Instalações Elétricas,3865.4941971308785,1865,27454,25589
6,Médio Incompleto,7157,Aplicadores De Materiais Isolantes,6672.0622334316795,30,3505,3475
6,Médio Incompleto,7161,Revestidores De Concreto,1752.5305688124558,-29,694,723
6,Médio Incompleto,7162,Telhadores (Revestimentos Rígidos),1755.3676896085638,22,309,287
6,Médio Incompleto,7163,Vidraceiros (Revestimentos Rígidos),2028.5648335826754,253,5679,5426
6,Médio Incompleto,7164,Gesseiros,2088.3188124759263,849,7757,6908
6,Médio Incompleto,7165,"Aplicadores De Revestimentos Cerâmicos, Pastilhas, Pedras E Madeiras",2297.024432023133,317,7235,6918
6,Médio Incompleto,7166,Pintores De Obras E Revestidores De Interiores (Revestimentos Flexíveis),1825.9134620210589,1114,23591,22477
6,Médio Incompleto,7170,Ajudantes De Obras Civis,11706.43247792574,37475,327193,289718
6,Médio Incompleto,7201,"Supervisores De Usinagem, Conformação E Tratamento De Metais",10862.890196922655,-124,1017,1141
6,Médio Incompleto,7202,Supervisores Da Fabricação E Montagem Metalmecânica,5610.082504254512,-130,238,368
6,Médio Incompleto,7211,Ferramenteiros E Afins,3133.2216955283748,-2,1783,1785
6,Médio Incompleto,7212,Preparadores E Operadores De Máquinas-Ferramenta Convencionais,5801.2771594832175,77,15195,15118
6,Médio Incompleto,7213,Afiadores E Polidores De Metais,2436.37567706447,41,3268,3227
6,Médio Incompleto,7214,Operadores De Máquinas De Usinagem Cnc,6251.799192546216,145,4145,4000
6,Médio Incompleto,7221,Trabalhadores De Forjamento De Metais,1849.0052098989318,-26,1178,1204
6,Médio Incompleto,7222,Trabalhadores De Fundição De Metais Puros E De Ligas Metálicas,1811.9736876068814,748,6250,5502
6,Médio Incompleto,7223,Trabalhadores De Moldagem De Metais E De Ligas Metálicas,2006.2071628019487,252,2816,2564
6,Médio Incompleto,7224,Trabalhadores De Trefilação E Estiramento De Metais Puros E Ligas Metálicas,2262.5349522535685,-23,338,361
6,Médio Incompleto,7231,Trabalhadores De Tratamento Térmico De Metais,2257.328919379335,-4,393,397
6,Médio Incompleto,7232,Trabalhadores De Tratamento De Superfícies De Metais E De Compósitos (Termoquímicos),2164.8405539243518,-90,1655,1745
6,Médio Incompleto,7233,"Trabalhadores Da Pintura De Equipamentos, Veículos, Estruturas Metálicas E De Compósitos",2243.305333073648,144,12331,12187
6,Médio Incompleto,7241,Encanadores E Instaladores De Tubulações,2522.0589701473114,603,17975,17372
6,Médio Incompleto,7242,Trabalhadores De Traçagem E Montagem De Estruturas Metálicas E De Compósitos,95082.93054537597,4049,37036,32987
6,Médio Incompleto,7243,Trabalhadores De Soldagem E Corte De Ligas Metálicas,3927.767181404167,1127,38974,37847
6,Médio Incompleto,7244,Trabalhadores De Caldeiraria E Serralheria,4463.177476792417,1516,26860,25344
6,Médio Incompleto,7245,Operadores De Máquinas De Conformação De Metais,2536.016037975481,-255,4633,4888
6,Médio Incompleto,7246,Trançadores E Laceiros De Cabos De Aço,1785.592021948983,-8,107,115
6,Médio Incompleto,7250,Ajustadores Mecânicos Polivalentes E Afins,3571.7193290728596,1598,11632,10034
6,Médio Incompleto,7251,"Montadores De Máquinas, Aparelhos E Acessórios Em Linhas De Montagem",3119.969417624629,427,5167,4740
6,Médio Incompleto,7252,Montadores De Máquinas Industriais,2611.905102560035,912,10416,9504
6,Médio Incompleto,7253,Montadores De Máquinas Pesadas E Equipamentos Agrícolas,4212.27527723076,289,1441,1152
6,Médio Incompleto,7254,Mecânicos Montadores De Motores E Turboalimentadores,1990.461920696795,-17,514,531
6,Médio Incompleto,7255,Montadores De Veículos Automotores (Linha De Montagem),2146.6806117205197,-283,1298,1581
6,Médio Incompleto,7256,Montadores De Sistemas E Estruturas De Aeronaves,2487.8501774379183,1,17,16
6,Médio Incompleto,7257,Instaladores De Equipamentos De Refrigeração E Ventilação,1862.586285142738,-126,1898,2024
6,Médio Incompleto,7301,Supervisores De Montagens E Instalações Eletroeletrônicas,3347.428750786288,-76,252,328
6,Médio Incompleto,7311,Montadores De Equipamentos Eletroeletrônicos,1916.5520550623485,2458,19291,16833
6,Médio Incompleto,7312,Montadores De Aparelhos De Telecomunicações,1459.9725787430614,-36,290,326
6,Médio Incompleto,7313,Instaladores-Reparadores De  Linhas E Equipamentos De Telecomunicações,1468.7033022479045,-57,3935,3992
6,Médio Incompleto,7321,"Instaladores E Reparadores De Linhas E Cabos Elétricos, Telefônicos E De Comunicação De Dados",3081.9759662255915,353,14210,13857
6,Médio Incompleto,7401,Supervisores Da Mecânica De Precisão E Instrumentos Musicais,27478.34408618786,-12,21,33
6,Médio Incompleto,7411,Mecânicos De Instrumentos De Precisão,1429.1219422822833,126,1297,1171
6,Médio Incompleto,7421,Confeccionadores De Instrumentos Musicais,1552.0860196505892,8,64,56
6,Médio Incompleto,7501,Supervisores De Joalheria E Afins,1980.3489540501644,-3,8,11
6,Médio Incompleto,7502,"Supervisores De Vidraria, Cerâmica E Afins",3300.4946838378905,-10,25,35
6,Médio Incompleto,7510,Joalheiros E Lapidadores De Gemas,1604.4052562936135,39,648,609
6,Médio Incompleto,7511,Artesãos De Metais Preciosos E Semi-Preciosos,1652.8414560239755,-32,780,812
6,Médio Incompleto,7521,"Sopradores, Moldadores E Modeladores De Vidros E Afins",1754.0611696421593,30,254,224
6,Médio Incompleto,7522,Trabalhadores Da Transformação De Vidros Planos,1807.3738054573914,-53,1065,1118
6,Médio Incompleto,7523,Ceramistas (Preparação E Fabricação),1691.3412641520472,703,8006,7303
6,Médio Incompleto,7524,Vidreiros E Ceramistas (Arte E Decoração),1609.6547058189842,-38,303,341
6,Médio Incompleto,7601,Supervisores Da Indústria Têxtil,3379.710107794327,-216,1175,1391
6,Médio Incompleto,7602,Supervisores Na Indústria Do Curtimento,3460.786173502604,-9,6,15
6,Médio Incompleto,7603,Supervisores Na Confecção Do Vestuário,2152.545979783596,-427,762,1189
6,Médio Incompleto,7604,Supervisores Na Confecção De Calçados,3280.374841808882,-290,770,1060
6,Médio Incompleto,7605,"Supervisores Da Confecção De Artefatos De Tecidos, Couros E Afins",2372.0650959014893,-44,186,230
6,Médio Incompleto,7606,Supervisores Das Artes Gráficas,2835.2066724823744,-42,102,144
6,Médio Incompleto,7610,Trabalhadores Polivalentes Das Indústrias Têxteis,3066.5718586210596,966,9256,8290
6,Médio Incompleto,7611,Trabalhadores Da Classificação De Fibras Têxteis E Lavagem De Lã,1586.6576461011146,58,323,265
6,Médio Incompleto,7612,Operadores Da Fiação,1814.3610864446937,-14,3055,3069
6,Médio Incompleto,7613,Operadores De Tear E Máquinas Similares,1795.6981996708143,-176,6293,6469
6,Médio Incompleto,7614,"Trabalhadores De Acabamento, Tingimento E Estamparia Das Indústrias Têxteis",2461.6568759365505,-22,4228,4250
6,Médio Incompleto,7618,Inspetores E Revisores De Produção Têxtil,1751.8024450332528,200,6479,6279
6,Médio Incompleto,7620,Trabalhadores Polivalentes Do Curtimento De Couros E Peles,2000.9844218433886,483,4156,3673
6,Médio Incompleto,7621,Trabalhadores Da Preparação Do Curtimento De Couros E Peles,2725.6381389164876,-29,265,294
6,Médio Incompleto,7622,Trabalhadores Do Curtimento De Couros E Peles,1711.175686746202,-32,747,779
6,Médio Incompleto,7623,Trabalhadores Do Acabamento De Couros E Peles,1658.4032799594954,-57,1143,1200
6,Médio Incompleto,7630,Profissionais Polivalentes Da Confecção De Roupas,1606.8724744968788,-350,6190,6540
6,Médio Incompleto,7631,Trabalhadores Da Preparação Da Confecção De Roupas,44063.076433590184,3190,34843,31653
6,Médio Incompleto,7632,Operadores De Máquinas Para Costura De Peças Do Vestuário,1463.9674647207312,-3565,51499,55064
6,Médio Incompleto,7633,Operadores De Máquinas Para Bordado E Acabamento De Roupas,1516.6412511262274,-197,8361,8558
6,Médio Incompleto,7640,Trabalhadores Polivalentes Da Confecção De Calçados,1300.9444729210932,3760,36589,32829
6,Médio Incompleto,7641,Trabalhadores Da Preparação Da Confecção De Calçados,1551.4813153276793,1190,19181,17991
6,Médio Incompleto,7642,Operadores De Máquinas De Costurar E Montar Calçados,1796.7646785771562,-549,7858,8407
6,Médio Incompleto,7643,Trabalhadores De Acabamento De Calçados,1522.9074267568903,109,6270,6161
6,Médio Incompleto,7650,Trabalhadores Polivalentes Da Confecção De Artefatos De Tecidos E Couros,1288.9901043237703,28,567,539
6,Médio Incompleto,7651,"Trabalhadores Da Preparação De Artefatos De Tecidos, Couros E Tapeçaria",1581.3353975376187,-62,840,902
6,Médio Incompleto,7652,"Trabalhadores Da Confecção De Artefatos De Tecidos, Couros E Sintéticos",1796.059951660234,-87,4218,4305
6,Médio Incompleto,7653,Operadores De Máquinas Na Confecção De Artefatos De  Couro,1977.1195878164099,-42,635,677
6,Médio Incompleto,7654,Trabalhadores Do Acabamento De Artefatos De Tecidos E Couros,1417.378024047008,90,1759,1669
6,Médio Incompleto,7661,Trabalhadores Da Pré-Impressão Gráfica,2029.351976631448,-105,1380,1485
6,Médio Incompleto,7662,Trabalhadores Da Impressão Gráfica,2175.7887919322725,-711,4973,5684
6,Médio Incompleto,7663,Trabalhadores Do Acabamento Gráfico,1882.8410451998443,-10,5570,5580
6,Médio Incompleto,7664,Trabalhadores De Laboratório Fotográfico E Radiológico,1956.0217125201184,-54,131,185
6,Médio Incompleto,7681,"Trabalhadores De Tecelagem Manual, Tricô, Crochê, Rendas E Afins",1462.9636129952494,-11,330,341
6,Médio Incompleto,7682,Trabalhadores Artesanais Da Confecção De Peças E Tecidos,1997.9776836131196,0,200,200
6,Médio Incompleto,7683,Trabalhadores Artesanais Da Confecção De Calçados E Artefatos De Couros E Peles,7154.048034531622,372,4031,3659
6,Médio Incompleto,7686,Trabalhadores Tipográficos Linotipistas E Afins,2186.0961007549427,-43,216,259
6,Médio Incompleto,7687,Encadernadores E Recuperadores De Livros (Pequenos Lotes Ou A Unidade),1439.0906322303265,-15,65,80
6,Médio Incompleto,7701,"Supervisores Em Indústria De Madeira, Mobiliário E Da Carpintaria Veicular",2699.744512399332,-163,718,881
6,Médio Incompleto,7711,Marceneiros E Afins,1820.1691049432018,681,16735,16054
6,Médio Incompleto,7721,Trabalhadores De Tratamento E Preparação Da Madeira,1506.453599703741,253,4861,4608
6,Médio Incompleto,7731,Operadores De Máquinas De Desdobramento Da Madeira,2199.389371501124,-185,6111,6296
6,Médio Incompleto,7732,Operadores De Máquinas De Aglomeração E Prensagem De Chapas,1974.5449279146162,6,457,451
6,Médio Incompleto,7733,Operadores De Usinagem Convencional De Madeira,2536.2001704993995,-336,4555,4891
6,Médio Incompleto,7734,Operadores De Máquina De Usinar Madeira (Produção Em Série),2018.9876624144008,-50,1472,1522
6,Médio Incompleto,7735,Operadores De Máquinas De Usinagem De Madeira Cnc,1569.8895928739767,-34,539,573
6,Médio Incompleto,7741,Montadores De Móveis E Artefatos De Madeira,1659.1355863864787,-78,13474,13552
6,Médio Incompleto,7751,Trabalhadores De Arte E  Do Acabamento Em Madeira Do Mobiliário,1527.4125122052608,-6,1171,1177
6,Médio Incompleto,7764,"Confeccionadores De Artefatos De Madeira, Móveis De Vime E Afins",1303.3119183111032,0,410,410
6,Médio Incompleto,7771,Carpinteiros Navais,2085.715442882955,8,51,43
6,Médio Incompleto,7772,Carpinteiros De Carrocerias E Carretas,1676.0536705556542,-26,115,141
6,Médio Incompleto,7801,Supervisores De Trabalhadores De Embalagem E Etiquetagem,2779.3761697099258,-201,328,529
6,Médio Incompleto,7811,Condutores De Processos Robotizados,1609.7715675548002,24,189,165
6,Médio Incompleto,7813,Operadores De Equipamentos Pilotados Remotamente,2025.3955905566843,16,40,24
6,Médio Incompleto,7817,Trabalhadores Subaquáticos,1517.4973544236068,11,51,40
6,Médio Incompleto,7821,Operadores De Máquinas E Equipamentos De Elevação,3483.2261891173557,129,6345,6216
6,Médio Incompleto,7822,Operadores De Equipamentos De Movimentação De Cargas,2441.818757294513,-2490,12126,14616
6,Médio Incompleto,7823,Motoristas De Veículos De Pequeno E Médio Porte,1845.1933209431863,-2556,42237,44793
6,Médio Incompleto,7824,"Motoristas De Ônibus Urbanos, Metropolitanos E Rodoviários",2340.129930749252,-5086,26118,31204
6,Médio Incompleto,7825,Motoristas De Veículos De Cargas Em Geral,2820.482403793309,7038,170139,163101
6,Médio Incompleto,7826,Operadores De Veículos Sobre Trilhos E Cabos Aéreos,2794.7035819296866,-30,101,131
6,Médio Incompleto,7827,Trabalhadores Aquaviários,1825.405491920394,-91,1461,1552
6,Médio Incompleto,7828,Condutores De Animais E De Veículos De Tração Animal E Pedais,1616.3864974276305,-120,563,683
6,Médio Incompleto,7831,Trabalhadores De Manobras De Transportes Sobre Trilhos,1902.1361629390062,66,1877,1811
6,Médio Incompleto,7832,Trabalhadores De Cargas E Descargas De Mercadorias,1621.4068771560812,14875,155815,140940
6,Médio Incompleto,7841,Trabalhadores De Embalagem E De Etiquetagem,1647.7221247678074,21867,142506,120639
6,Médio Incompleto,7842,Alimentadores De Linhas De Produção,1934.329509340227,70387,454123,383736
6,Médio Incompleto,7911,Artesãos,3929.5595718849872,43,300,257
6,Médio Incompleto,8101,"Supervisores De Produção Em Indústrias Químicas, Petroquímicas E Afins",2810.708243657716,-75,72,147
6,Médio Incompleto,8102,Supervisores De Produção Em Indústrias De Transformação De Plásticos E Borrachas,4928.78693417438,-129,142,271
6,Médio Incompleto,8103,"Supervisores De Produção Em Indústrias De Produtos Farmacêuticos, Cosméticos E Afins",2058.9509626116073,-10,16,26
6,Médio Incompleto,8110,"Operadores Polivalentes De Equipamentos Em Indústrias Químicas, Petroquímicas E Afins",1967.9948269299725,-36,178,214
6,Médio Incompleto,8111,Operadores De Equipamentos De Moagem E Mistura De Materiais (Tratamentos Químicos E Afins),1684.0413360515502,40,1567,1527
6,Médio Incompleto,8112,Operadores De Calcinação E De Tratamentos Químicos De Materiais Radioativos,1490.7819751026186,-23,112,135
6,Médio Incompleto,8113,Operadores De Equipamentos De Filtragem E Separação,4726.688165178694,-262,360,622
6,Médio Incompleto,8114,"Operadores De Equipamentos De Destilação, Evaporação E Reação",5092.364454359479,-48,517,565
6,Médio Incompleto,8115,Operadores De Equipamentos De Produção E Refino De Petróleo E Gás,1808.6738858904157,-2,35,37
6,Médio Incompleto,8116,Operadores De Equipamentos De Coqueificação,1778.6651278601744,-38,275,313
6,Médio Incompleto,8117,"Operadores De Instalações E Máquinas De Produtos Plásticos, De Borracha E Moldadores De Parafinas",2125.602069911696,-101,14199,14300
6,Médio Incompleto,8118,"Operadores De Máquinas E Instalações De Produtos Farmacêuticos, Cosméticos E Afins",1674.7058397799958,-156,1037,1193
6,Médio Incompleto,8121,Trabalhadores Da Fabricação De Munição E Explosivos Químicos,1406.709562640353,57,364,307
6,Médio Incompleto,8131,"Operadores De Processos Das Indústrias De Transformação De Produtos Químicos, Petroquímicos E Afins",3173.9846040276557,144,5859,5715
6,Médio Incompleto,8181,Laboratoristas Industriais Auxiliares,3732.1265007073434,245,2348,2103
6,Médio Incompleto,8201,Supervisores De Produção Em Indústrias Siderúrgicas,2635.5586576278683,-40,69,109
6,Médio Incompleto,8202,Supervisores Na Fabricação De Materiais Para Construção (Vidros E Cerâmicas),5952.318749862777,-91,196,287
6,Médio Incompleto,8211,Operadores De Instalações De Sinterização,1667.5068673939668,-10,172,182
6,Médio Incompleto,8212,Operadores De Fornos De Primeira  Fusão E Aciaria,1849.0772446711924,-26,2139,2165
6,Médio Incompleto,8213,Operadores De Equipamentos De Laminação,2040.564124230824,-18,1099,1117
6,Médio Incompleto,8214,Operadores De Equipamentos De Acabamento De Chapas E Metais,2484.9931091810336,450,9061,8611
6,Médio Incompleto,8221,Forneiros Metalúrgicos (Segunda Fusão E Reaquecimento),2866.475298246602,-70,300,370
6,Médio Incompleto,8231,"Operadores Na Preparação De Massas Para Abrasivo, Vidro, Cerâmica, Porcelana E Materiais De Construção",1818.331632903824,59,548,489
6,Médio Incompleto,8232,"Operadores De Equipamentos De Fabricação  E Beneficiamento De Cristais, Vidros, Cerâmicas, Porcelanas, Fibras De Vidro, Abrasivos E Afins",2159.6134164063697,-89,890,979
6,Médio Incompleto,8233,Operadores De Instalações E Equipamentos De Fabricação De Materiais De Construção,1556.6725877676422,678,7939,7261
6,Médio Incompleto,8281,Trabalhadores Da Fabricação De Cerâmica Estrutural Para Construção,1652.911216706946,30,7552,7522
6,Médio Incompleto,8301,Supervisores Da Fabricação De Celulose E Papel,16573.39358990009,-56,50,106
6,Médio Incompleto,8311,Preparadores De Pasta Para Fabricação De Papel,2403.7134938316744,39,280,241
6,Médio Incompleto,8321,Operadores De Máquinas De Fabricar Papel E Papelão,3114.7914309274165,-142,1408,1550
6,Médio Incompleto,8331,Operadores De Máquinas Na Fabricação De Produtos De Papel E Papelão,2329.8750424092327,81,2321,2240
6,Médio Incompleto,8332,Trabalhadores Artesanais De Produtos De Papel E Papelão,1335.9005212395896,119,1006,887
6,Médio Incompleto,8401,"Supervisores Da Fabricação De Alimentos, Bebidas E Fumo",2319.625759978392,-496,677,1173
6,Médio Incompleto,8411,"Trabalhadores Da Indústria De Beneficiamento De Grãos, Cereais E Afins",1989.3767512256638,83,1965,1882
6,Médio Incompleto,8412,Trabalhadores No Beneficiamento Do Sal,4017.646742597183,59,479,420
6,Médio Incompleto,8413,Trabalhadores Na Fabricação E Refino De Açúcar,7077.532677131962,184,1684,1500
6,Médio Incompleto,8414,Trabalhadores Na Fabricação E Conservação De Alimentos,1708.8085368009113,-154,14561,14715
6,Médio Incompleto,8415,Trabalhadores Na Pasteurização Do Leite E Na Fabricação De Laticínios  E Afins,1440.41653920293,422,6746,6324
6,Médio Incompleto,8416,"Trabalhadores Na Industrialização De Café, Cacau, Mate E De Produtos Afins",1538.992188439749,-65,188,253
6,Médio Incompleto,8417,"Trabalhadores Na Fabricação De Cachaça, Cerveja, Vinhos E Outras Bebidas",2096.4473974417488,213,1934,1721
6,Médio Incompleto,8418,"Operadores De Equipamentos Na Fabricação De Pães, Massas Alimentícias, Doces, Chocolates E Achocolatados",1536.6148868527416,-575,3773,4348
6,Médio Incompleto,8421,Cigarreiros E Beneficiadores De Fumo,1515.7124253655459,532,6914,6382
6,Médio Incompleto,8422,Charuteiros,1592.7179245827415,8,22,14
6,Médio Incompleto,8481,Trabalhadores Artesanais Na Conservação De Alimentos,1826.9340070937394,-113,2272,2385
6,Médio Incompleto,8482,Trabalhadores Artesanais Na Pasteurização Do Leite E Na Fabricação De Laticínios E Afins,1469.8816509212586,-78,1008,1086
6,Médio Incompleto,8483,"Padeiros, Confeiteiros E Afins",1639.867749295133,-3474,27436,30910
6,Médio Incompleto,8484,Trabalhadores Na Degustação E Classificação De Grãos E Afins,1591.633788559578,164,2460,2296
6,Médio Incompleto,8485,Magarefes E Afins,1575.4441065479448,4474,127712,123238
6,Médio Incompleto,8486,Trabalhadores Artesanais Na Indústria Do Fumo,1348.9928791845086,37,829,792
6,Médio Incompleto,8601,Supervisores Da Produção De Utilidades,2927.3679517487867,-121,289,410
6,Médio Incompleto,8611,"Operadores De Instalações De Geração E Distribuição De Energia Elétrica, Hidráulica, Térmica Ou Nuclear",1878.231951731818,-16,193,209
6,Médio Incompleto,8612,Operadores De Instalações De Distribuição De Energia Elétrica,1857.1915290880504,-57,51,108
6,Médio Incompleto,8621,Operadores De Máquinas A Vapor E Utilidades,4017.840780816712,-2546,21120,23666
6,Médio Incompleto,8622,"Operadores De Instalações De Captação, Tratamento E Distribuição De Água",6377.553550667028,161,727,566
6,Médio Incompleto,8623,Operadores De Instalações De Captação E Esgotos,1536.5323278146323,118,1632,1514
6,Médio Incompleto,8624,"Operadores De Instalações De Extração, Processamento, Envasamento E Distribuição De Gases",3599.734656131629,-10,127,137
6,Médio Incompleto,8625,Operadores De Instalações De Refrigeração E Ar-Condicionado,1688.493789502774,-76,608,684
6,Médio Incompleto,9101,"Supervisores Em Serviços De Reparação E Manutenção De Máquinas E Equipamentos Industriais, Comerciais E Residenciais",4608.257917811618,-258,1369,1627
6,Médio Incompleto,9102,Supervisores Em Serviços De Reparação E Manutenção Veicular,2652.687447262433,-146,369,515
6,Médio Incompleto,9109,"Supervisores De Outros Trabalhadores De Serviços De Reparação, Conservação E Manutenção",2736.672361179274,-18,56,74
6,Médio Incompleto,9111,"Mecânicos De Manutenção De Bombas, Motores, Compressores E Equipamentos De Transmissão",3264.237739335145,340,3717,3377
6,Médio Incompleto,9112,Mecânicos De Manutenção E Instalação De Aparelhos De  Climatização E Refrigeração,2053.404926834625,203,4958,4755
6,Médio Incompleto,9113,Mecânicos De Manutenção De Máquinas Industriais,2991.9947946021225,5178,47680,42502
6,Médio Incompleto,9131,Mecânicos De Manutenção De Máquinas Pesadas E Equipamentos Agrícolas,2790.9332642992367,1038,7615,6577
6,Médio Incompleto,9141,Mecânicos De Manutenção Aeronáutica,1754.3726481800836,-27,321,348
6,Médio Incompleto,9142,Mecânicos De Manutenção De Motores E Equipamentos Navais,1917.4140018717449,-2,74,76
6,Médio Incompleto,9143,Mecânicos De Manutenção Metroferroviária,1835.6956916960364,-19,312,331
6,Médio Incompleto,9144,Mecânicos De Manutenção De Veículos Automotores,2354.78580038331,2051,46472,44421
6,Médio Incompleto,9151,Técnicos Em Manutenção E Reparação De Instrumentos De Medição E Precisão,1823.7071423721934,38,269,231
6,Médio Incompleto,9152,Restauradores De Instrumentos Musicais,1602.3938598632813,3,9,6
6,Médio Incompleto,9153,Técnicos Em Manutenção E Reparação De Equipamentos Biomédicos,1941.2585256476152,36,113,77
6,Médio Incompleto,9154,Reparadores De Equipamentos Fotográficos,1386.604282924107,1,4,3
6,Médio Incompleto,9191,Lubrificadores,2090.5851954843165,-83,3580,3663
6,Médio Incompleto,9192,"Trabalhadores De Manutenção De Roçadeiras, Motoserras E Similares",1972.7218377923718,-147,2244,2391
6,Médio Incompleto,9193,Mecânicos De Manutenção De Bicicletas E Equipamentos Esportivos E De Ginástica,1584.550377517021,120,2080,1960
6,Médio Incompleto,9501,"Supervisores De Manutenção Eletroeletrônica Industrial, Comercial E Predial",4761.819295459688,-222,856,1078
6,Médio Incompleto,9502,Supervisores De Manutenção Eletroeletrônica Veicular,2310.0952953116243,-47,88,135
6,Médio Incompleto,9503,Supervisores De Manutenção Eletromecânica,7002.675729801037,-46,112,158
6,Médio Incompleto,9511,Eletricistas De Manutenção Eletroeletrônica,2504.4461740107167,1426,14410,12984
6,Médio Incompleto,9513,Instaladores E Mantenedores De Sistemas Eletroeletrônicos De Segurança,1676.0792957326241,186,4191,4005
6,Médio Incompleto,9531,"Eletricistas Eletrônicos De Manutenção Veicular (Aérea, Terrestre E Naval)",2473.8857958398617,-13,4455,4468
6,Médio Incompleto,9541,"Instaladores E Mantenedores Eletromecânicos De Elevadores, Escadas E Portas Automáticas",2321.084498417723,740,3576,2836
6,Médio Incompleto,9542,Reparadores De Aparelhos Eletrodomésticos,1415.8920059194656,-44,294,338
6,Médio Incompleto,9543,Reparadores De Equipamentos De Escritório,1526.1552298038564,9,122,113
6,Médio Incompleto,9911,Conservadores De Vias Permanentes (Trilhos),2030.4913768275874,403,2440,2037
6,Médio Incompleto,9912,Mantenedores De Equipamentos De Parques De Diversões E Similares,1397.9108693399403,-23,173,196
6,Médio Incompleto,9913,Reparadores De Carrocerias De Veículos,2223.3300331152805,-285,5654,5939
6,Médio Incompleto,9921,Trabalhadores Elementares De Serviços De Manutenção Veicular,1890.3449895517706,456,9323,8867
6,Médio Incompleto,9922,Trabalhadores Operacionais De Conservação De Vias Permanentes (Exceto Trilhos),1895.0052348844215,2004,25011,23007
7,Médio Completo,0000,Não especificado,119051.30318471903,8033,13232,5199
7,Médio Completo,0101,Oficiais Generais Das Forças Armadas,1502.0676034656033,34,1888,1854
7,Médio Completo,0102,Oficiais Das Forças Armadas,2290.6954259140584,24,198,174
7,Médio Completo,0103,Praças Das Forças Armadas,1586.753968753489,18,206,188
7,Médio Completo,0201,Oficiais Superiores Da Polícia Militar,1544.3258133248537,-3,47,50
7,Médio Completo,0202,Capitães Da  Polícia Militar,1174.6666666666667,-1,1,2
7,Médio Completo,0203,Tenentes Da Polícia Militar,1154.030029296875,1,3,2
7,Médio Completo,0211,Subtenentes E Sargentos Da Policia Militar,1398.2870155068513,32,64,32
7,Médio Completo,0212,Cabos E Soldados Da Polícia Militar,1569.5728236607142,1,8,7
7,Médio Completo,0301,Oficiais Superiores Do Corpo De Bombeiros Militar,1630.218246851212,3,22,19
7,Médio Completo,0302,Oficiais Intermediários Do Corpo De Bombeiros Militar,1586.2617782201523,13,26,13
7,Médio Completo,0303,Tenentes Do Corpo De Bombeiros Militar,2487.223347981771,0,6,6
7,Médio Completo,0311,Subtenentes E Sargentos Do Corpo De Bombeiros Militar,2023.831242879232,2,10,8
7,Médio Completo,0312,Cabos E Soldados Do Corpo De Bombeiros Militar,2132.570849609375,4,22,18
7,Médio Completo,1111,Legisladores,3293.8032300388327,224,882,658
7,Médio Completo,1112,Dirigentes Gerais Da Administração Pública,2911.702827519259,695,2520,1825
7,Médio Completo,1113,Magistrados,2159.0803277573964,-48,92,140
7,Médio Completo,1114,Dirigentes Do Serviço Público,1756.7743150248873,1475,4206,2731
7,Médio Completo,1115,Gestores Públicos,3861.2427911589484,608,1852,1244
7,Médio Completo,1130,"Dirigentes De Povos Indígenas, De Quilombolas E Caiçaras",2214.235012004657,20,122,102
7,Médio Completo,1141,Dirigentes De Partidos Políticos,4262.110185731132,-1,26,27
7,Médio Completo,1142,Dirigentes E Administradores De Entidades Patronais E Dos Trabalhadores E De Outros Interesses Sócioeconômicos,2835.0283425166117,0,244,244
7,Médio Completo,1143,Dirigentes E Administradores De Entidades Religiosas,2630.3878424813815,-11,48,59
7,Médio Completo,1144,Dirigentes E Administradores De Organizações Da Sociedade Civil Sem Fins Lucrativos,3721.3288649427946,-9,101,110
7,Médio Completo,1210,Diretores Gerais,3438.829633526336,-37,6934,6971
7,Médio Completo,1221,"Diretores De Produção E Operações Em Empresa Agropecuária, Pesqueira , Aqüícola E Florestal",3706.3341521075645,-12,132,144
7,Médio Completo,1222,"Diretores De Produção E Operações Em Empresa Da Indústria Extrativa, Transformação E De Serviços De Utilidade Pública",6073.2526209125945,-27,190,217
7,Médio Completo,1223,Diretores De Operações De Obras Em Empresa De Construção,4153.640502980635,0,300,300
7,Médio Completo,1224,Diretores De Operações Em Empresa Do Comércio,4629.645135128137,-54,468,522
7,Médio Completo,1225,"Diretores De Serviços De Turismo, De Alojamento E De Alimentação",2239.9565414967883,104,632,528
7,Médio Completo,1226,"Diretores De Operações De Serviços Em Empresa De Armazenamento, De Transporte E De Telecomunicação",3558.4820768678983,-201,718,919
7,Médio Completo,1227,Diretores De Operações De Serviços Em Instituição De Intermediação Financeira,14300.061596200789,-25,150,175
7,Médio Completo,1231,Diretores Administrativos E Financeiros,6232.757600893332,-477,9573,10050
7,Médio Completo,1232,Diretores De Recursos Humanos E Relações De Trabalho,5047.673748118941,-50,263,313
7,Médio Completo,1233,Diretores De Comercialização E Marketing,5826.46897291979,-266,2308,2574
7,Médio Completo,1234,Diretores De Suprimentos E Afins,3780.9279608154297,-75,182,257
7,Médio Completo,1236,Diretores De Tecnologia Da Informação,10246.863599424008,-158,191,349
7,Médio Completo,1237,Diretores De Pesquisa E Desenvolvimento,8419.438789636948,-69,93,162
7,Médio Completo,1238,Diretores De Manutenção,3211.161820867671,-48,423,471
7,Médio Completo,1311,"Diretores E Gerentes De Operações Em Empresa De Serviços Pessoais, Sociais E Culturais",3884.5988455888673,-427,3646,4073
7,Médio Completo,1312,"Gestores E Especialistas De Operações Em Empresas, Secretarias E Unidades De Serviços De Saúde",2815.6164428561397,-19,2789,2808
7,Médio Completo,1313,Diretores E Gerentes De Instituição De Serviços Educacionais,2774.8857160800553,-86,3455,3541
7,Médio Completo,1411,"Gerentes De Produção E Operações Em Empresa Agropecuária, Pesqueira, Aqüícola E Florestal",3407.212141979432,1199,9694,8495
7,Médio Completo,1412,"Gerentes De Produção E Operações Em Empresa Da Indústria Extrativa, De Transformação E De Serviços De Utilidade Pública",3470.3209623317675,-1316,36141,37457
7,Médio Completo,1413,Gerentes De Obras Em Empresa De Construção,4132.792399207833,368,6985,6617
7,Médio Completo,1414,Gerentes De Operações Comerciais E De Assistência Técnica,2526.725368311946,-28385,171163,199548
7,Médio Completo,1415,"Gerentes De Operações De Serviços Em Empresa De Turismo, De Alojamento E Alimentação",2434.7796236464023,-10720,49784,60504
7,Médio Completo,1416,"Gerentes De Operações De Serviços Em Empresa De Transporte, De Comunicação E De Logística (Armazenagem E Distribuição)",3246.886367935662,-2758,25075,27833
7,Médio Completo,1417,Gerentes De Operações De Serviços Em Instituição De Intermediação Financeira,4036.2494836138258,-861,1961,2822
7,Médio Completo,1418,Gerentes Operacionais Da Aviação Civil,3998.6293318172943,100,248,148
7,Médio Completo,1421,"Gerentes Administrativos, Financeiros, De Riscos E Afins",786145.9625056053,-10290,161069,171359
7,Médio Completo,1422,Gerentes De Recursos Humanos E De Relações Do Trabalho,3553.297752265653,-2217,8621,10838
7,Médio Completo,1423,"Gerentes De Comercialização, Marketing E Comunicação",11030.968647836078,-13176,210421,223597
7,Médio Completo,1424,Gerentes De Suprimentos E Afins,3261.3124673715533,-1696,9604,11300
7,Médio Completo,1425,Gerentes De Tecnologia Da Informação,6549.73272099993,-724,6980,7704
7,Médio Completo,1426,Gerentes De Pesquisa E Desenvolvimento E Afins,4350.564457578054,-412,1280,1692
7,Médio Completo,1427,Gerentes De Manutenção E Afins,3586.5725785024483,-647,7707,8354
7,Médio Completo,2011,Profissionais Da Biotecnologia,5846.488786114433,156,321,165
7,Médio Completo,2012,Profissionais Da Metrologia,2920.632556923466,-7,456,463
7,Médio Completo,2021,"Engenheiros De Controle E Automação, Engenheiros Mecatrônicos E Afins",5175.96119618736,429,1791,1362
7,Médio Completo,2030,Pesquisadores Das Ciências Biológicas,3536.7238283732395,22,223,201
7,Médio Completo,2031,Pesquisadores Das Ciências Naturais E Exatas,3231.8745681930777,52,432,380
7,Médio Completo,2032,Pesquisadores De Engenharia E Tecnologia,5435.336079553108,-52,648,700
7,Médio Completo,2033,Pesquisadores Das Ciências Da Saúde,4577.992546626023,63,255,192
7,Médio Completo,2034,Pesquisadores Das Ciências Da Agricultura,3806.6851691678676,107,457,350
7,Médio Completo,2035,Pesquisadores Das Ciências Sociais E Humanas,2115.546946481658,2,307,305
7,Médio Completo,2041,Peritos Criminais E Judiciais,2167.1944444444443,6,9,3
7,Médio Completo,2111,Profissionais Da Matemática,3721.820986206905,63,958,895
7,Médio Completo,2112,Profissionais De Estatística E Afins,5675.286064705306,67,306,239
7,Médio Completo,2122,Engenheiros Em Computação,10850.968413055256,166,2013,1847
7,Médio Completo,2123,Administradores De Tecnologia Da Informação,3785.6539082217805,1272,7557,6285
7,Médio Completo,2124,Analistas De Tecnologia Da Informação,4860.438623777817,18657,99729,81072
7,Médio Completo,2131,Físicos,3146.825473319492,5,58,53
7,Médio Completo,2132,Químicos,2701.0492302982325,112,969,857
7,Médio Completo,2133,Profissionais Das Ciências Atmosféricas E Espaciais E De Astronomia,2769.263653923483,0,22,22
7,Médio Completo,2134,"Geólogos, Oceanógrafos, Geofísicos E Afins",3396.0604960369515,-9,335,344
7,Médio Completo,2140,Engenheiros Ambientais E Afins,3544.7396974759286,209,997,788
7,Médio Completo,2141,Arquitetos E Urbanistas,2801.712548703799,166,1750,1584
7,Médio Completo,2142,Engenheiros Civis E Afins,5822.934819452565,293,6526,6233
7,Médio Completo,2143,"Engenheiros Eletricistas, Eletrônicos E Afins",4523.358483777459,587,4466,3879
7,Médio Completo,2144,Engenheiros Mecânicos E Afins,6509.457010136944,267,1902,1635
7,Médio Completo,2145,Engenheiros Químicos E Afins,5995.352178790798,38,249,211
7,Médio Completo,2146,"Engenheiros Metalurgistas, De Materiais E Afins",5201.533390249401,79,321,242
7,Médio Completo,2147,Engenheiros De Minas E Afins,7391.31480591117,46,243,197
7,Médio Completo,2148,Engenheiros Agrimensores E Engenheiros Cartógrafos,3433.641245265883,6,95,89
7,Médio Completo,2149,"Engenheiros De Produção, Qualidade, Segurança E Afins",5219.860691194703,1119,6277,5158
7,Médio Completo,2151,Oficiais De Convés E Afins,3420.8069207805393,429,3350,2921
7,Médio Completo,2152,Oficiais De Máquinas Da Marinha Mercante,5896.6317603615125,118,818,700
7,Médio Completo,2153,Profissionais Da Pilotagem Aeronáutica,3941.6655637108447,406,3090,2684
7,Médio Completo,2211,Biólogos E Afins,3053.946902901555,27,782,755
7,Médio Completo,2212,Biomédicos,2671.402291642935,635,3983,3348
7,Médio Completo,2221,Engenheiros Agrossilvipecuários,5342.166232446887,216,1453,1237
7,Médio Completo,2222,Engenheiros De Alimentos E Afins,2600.687838948913,27,195,168
7,Médio Completo,2232,Cirurgiões-Dentistas,2582.721738304875,401,1767,1366
7,Médio Completo,2233,Veterinários E Zootecnistas,3076.589397249788,577,2127,1550
7,Médio Completo,2234,Farmacêuticos,3046.3652272224376,4864,25613,20749
7,Médio Completo,2235,Enfermeiros E Afins,3161.2853596666205,5181,33508,28327
7,Médio Completo,2236,Fisioterapeutas,2216.1652984397942,1226,5999,4773
7,Médio Completo,2237,Nutricionistas,2164.2582502201585,1705,9507,7802
7,Médio Completo,2238,Fonoaudiólogos,2685.7158216715616,59,1517,1458
7,Médio Completo,2239,"Terapeutas Ocupacionais, Ortoptistas E Psicomotricistas",2916.4122670043485,54,1166,1112
7,Médio Completo,2241,Profissionais Da Educação Física,4688.676528773433,4435,23451,19016
7,Médio Completo,2251,Médicos Clínicos,5713.6540544382715,-929,3105,4034
7,Médio Completo,2252,Médicos Em Especialidades Cirúrgicas,3855.256523520387,-52,498,550
7,Médio Completo,2253,Médicos Em Medicina Diagnóstica E Terapêutica,4435.062812865124,29,227,198
7,Médio Completo,2261,Osteopatas E Quiropraxistas,3279.6428571428573,4,7,3
7,Médio Completo,2263,"Profissionais Das Terapias Criativas,Equoterápicas E Naturológicas",2108.366426794673,52,129,77
7,Médio Completo,2311,Professores De Nível Superior Na Educação Infantil,2340.2260809385557,1693,14783,13090
7,Médio Completo,2312,Professores De Nível Superior Do Ensino Fundamental (Primeira A Quarta Séries),3761.682132524177,-410,23131,23541
7,Médio Completo,2313,Professores De Nível Superior No Ensino Fundamental De Quinta A Oitava Série,2830.9398536936897,846,8790,7944
7,Médio Completo,2321,Professores Do Ensino Médio,2711.5942216376543,239,7870,7631
7,Médio Completo,2331,Professores Do Ensino Profissional,1861.1291784681514,-105,820,925
7,Médio Completo,2332,Instrutores De Ensino Profissional,3608.978710805638,-3573,17833,21406
7,Médio Completo,2341,"Professores De Matemática, Estatística E Informática Do Ensino Superior",1670.9624999781554,-75,205,280
7,Médio Completo,2342,"Professores De Ciências Físicas, Químicas E Afins Do Ensino Superior",1615.3763209371928,21,82,61
7,Médio Completo,2343,"Professores De Arquitetura E Urbanismo, Engenharia, Geofísica E Geologia Do Ensino Superior",2204.486039901864,-133,36,169
7,Médio Completo,2344,Professores De Ciências Biológicas E Da Saúde Do Ensino Superior,2873.4292632006495,-49,1811,1860
7,Médio Completo,2345,Professores Na Área De Formação Pedagógica Do Ensino Superior,3375.291359474133,-2210,2330,4540
7,Médio Completo,2346,Professores Nas Áreas De Língua E Literatura Do Ensino Superior,3136.730568900683,1519,8602,7083
7,Médio Completo,2347,Professores De Ciências Humanas Do Ensino Superior,2222.960076885153,-188,190,378
7,Médio Completo,2348,"Professores De Ciências Econômicas, Administrativas E Contábeis Do Ensino Superior",2673.6404315586174,-110,563,673
7,Médio Completo,2349,Professores De Artes Do Ensino Superior,4339.451301265913,88,634,546
7,Médio Completo,2392,Professores De Educação Especial,2153.794409512889,611,2130,1519
7,Médio Completo,2394,"Programadores, Avaliadores E Orientadores De Ensino",2282.8490321317486,5732,32321,26589
7,Médio Completo,2410,Advogados,3880.5893850211737,1235,7507,6272
7,Médio Completo,2412,Procuradores E Advogados Públicos,3777.9072455512155,-4,20,24
7,Médio Completo,2413,Tabeliães E Registradores,2096.7145343380166,1560,4065,2505
7,Médio Completo,2422,Membros Do Ministério Público,1700.7485814226995,-2,17,19
7,Médio Completo,2423,Delegados De Polícia,3569.580078125,0,2,2
7,Médio Completo,2424,Defensores Públicos E Procuradores Da Assistência Judiciária,2507.6313900039427,8,48,40
7,Médio Completo,2429,Profissionais Da Inteligência,3079.6697883279912,17,48,31
7,Médio Completo,2511,Profissionais Em Pesquisa E Análise Antropológica Sociológica,3487.456718759648,46,219,173
7,Médio Completo,2512,Economistas,3218.904428899313,590,6609,6019
7,Médio Completo,2513,Profissionais Em Pesquisa E Análise Geográfica,3168.0959582382375,-5,42,47
7,Médio Completo,2514,Filósofos,1864.9471261160713,5,6,1
7,Médio Completo,2515,Psicólogos E Psicanalistas,3371.66846856808,1208,4327,3119
7,Médio Completo,2516,Assistentes Sociais E Economistas Domésticos,2031.6385062933525,1125,4947,3822
7,Médio Completo,2521,Administradores,2922.769009522758,8867,57261,48394
7,Médio Completo,2522,Contadores E Afins,3004.3975859922616,-701,20522,21223
7,Médio Completo,2523,Secretárias(Os) Executivas(Os) E Afins,1717.1024378949023,13222,97448,84226
7,Médio Completo,2524,Profissionais De Recursos Humanos,2747.945435522636,3171,27145,23974
7,Médio Completo,2525,Profissionais De Administração Ecônomico-Financeira,3789.8058160526293,2665,28742,26077
7,Médio Completo,2526,Profissionais Da Administração Dos Serviços De Segurança,3763.58723840391,27,945,918
7,Médio Completo,2527,"Profissionais De Planejamento, Programação E Controles Logisticos",2682.8757475085154,3512,14272,10760
7,Médio Completo,2531,Profissionais De Publicidade,3071.7670006380217,4305,25466,21161
7,Médio Completo,2532,Profissionais De Comercializacão E Consultoria De Serviços Bancários,3695.601079246558,3705,53531,49826
7,Médio Completo,2533,"Corretores De Valores, Ativos Financeiros, Mercadorias E Derivativos",1882.2999414848775,-294,1995,2289
7,Médio Completo,2534,Profissionais De Mídias Digitais E Afins,2067.144596907209,3514,8540,5026
7,Médio Completo,2541,Auditores Fiscais E Técnicos Da Receita Federal,1723.4398302769314,37,90,53
7,Médio Completo,2542,Auditores Fiscais Da Previdência Social,2257.10498046875,4,4,0
7,Médio Completo,2543,Auditores Fiscais Do Trabalho,1751.8577399196927,503,6059,5556
7,Médio Completo,2544,Fiscais De Tributos Estaduais E Municipais,3057.664075640286,42,668,626
7,Médio Completo,2545,Profissionais Da Fiscalização De Atividades Urbanas,1550.482095850022,448,1752,1304
7,Médio Completo,2611,Profissionais Do Jornalismo,2685.9071003540653,-464,7397,7861
7,Médio Completo,2612,Profissionais Da Informação,2826.3137379978,1824,8593,6769
7,Médio Completo,2613,Arquivistas E Museólogos,1713.644559917871,-179,3389,3568
7,Médio Completo,2614,"Filólogos,Tradutores ,Intérpretes E Afins",4400.420848198385,509,2430,1921
7,Médio Completo,2615,Profissionais Da Escrita,3563.904312099465,-67,683,750
7,Médio Completo,2616,Editores,2806.6532322625117,65,1119,1054
7,Médio Completo,2617,"Locutores, Comentaristas E Repórteres De Mídias Audiovisuais",2729.495977361281,-607,7345,7952
7,Médio Completo,2618,Fotógrafos Profissionais,2354.7391087534816,76,5256,5180
7,Médio Completo,2619,Assistentes De Direção (Tv) E Continuístas,2006.003504981279,19,93,74
7,Médio Completo,2621,Produtores Artísticos E Culturais,2776.270498797655,69,2988,2919
7,Médio Completo,2622,Diretores De Espetáculos E Afins,7339.947023815299,-152,480,632
7,Médio Completo,2623,Cenógrafos,2355.933969910476,-165,943,1108
7,Médio Completo,2624,"Artistas Visuais,Desenhistas Industriais E Conservadores-Restauradores De Bens Culturais",2559.7250207954785,7402,32258,24856
7,Médio Completo,2625,Atores,13457.898065093561,-420,918,1338
7,Médio Completo,2626,"Músicos Compositores, Arranjadores, Regentes E Musicólogos",1975.3553516401707,-90,658,748
7,Médio Completo,2627,Músicos Intérpretes,3274.682389076851,-147,1701,1848
7,Médio Completo,2628,Artistas Da Dança (Exceto Dança Tradicional E Popular),2920.6313798377755,114,2871,2757
7,Médio Completo,2629,Designer De Interiores De Nível Superior,1982.4501659176422,-6,296,302
7,Médio Completo,2631,"Ministros De Culto, Missionários, Teólogos E Profissionais Assemelhados",1926.0850329924442,3,1013,1010
7,Médio Completo,2711,Chefes De Cozinha E Afins,2116.2494345330856,-1741,26242,27983
7,Médio Completo,3001,Técnicos Em Mecatrônica,3113.3435077095696,1310,6572,5262
7,Médio Completo,3003,Técnicos Em Eletromecânica,2861.5180487249045,4032,17993,13961
7,Médio Completo,3011,Técnicos De Laboratório Industrial,2690.4531765089214,3137,34105,30968
7,Médio Completo,3012,Técnicos De Apoio À Bioengenharia,2389.4291623052723,36,185,149
7,Médio Completo,3111,Técnicos Químicos,3058.6129044366207,1025,14916,13891
7,Médio Completo,3112,"Técnicos De Produção De Indústrias Químicas, Petroquímicas, Refino De Petróleo, Gás E Afins",2652.5782342067982,386,881,495
7,Médio Completo,3113,"Técnicos Em Materiais, Produtos Cerâmicos E Vidros",21378.85499746763,23,633,610
7,Médio Completo,3114,Técnicos Em Fabricação De Produtos Plásticos E De Borracha,1981.5970283579254,747,7233,6486
7,Médio Completo,3115,"Técnicos Em Controle Ambiental, Utilidades E Tratamento De Efluentes",2626.2489545766844,1288,10583,9295
7,Médio Completo,3116,Técnicos Têxteis,2647.820012784744,-182,692,874
7,Médio Completo,3117,Coloristas,2684.4972165050312,1671,27201,25530
7,Médio Completo,3121,Técnicos Em Construção Civil (Edificações),3315.8932568200576,6406,45273,38867
7,Médio Completo,3122,Técnicos Em Construção Civil (Obras De Infraestrutura),2877.053118512984,867,7248,6381
7,Médio Completo,3123,Técnicos Em Geomática,3067.9242414921755,4566,40267,35701
7,Médio Completo,3131,Técnicos Em Eletricidade E Eletrotécnica,3389.1279914431107,7365,99112,91747
7,Médio Completo,3132,Técnicos Em Eletrônica,3844.428011965216,11116,136334,125218
7,Médio Completo,3133,Técnicos Em Telecomunicações,1862.2248550747295,7647,74650,67003
7,Médio Completo,3134,Técnicos Em Calibração E Instrumentação,3797.836015189441,1151,20947,19796
7,Médio Completo,3135,Técnicos Em Fotônica,2041.2929176981702,-305,11298,11603
7,Médio Completo,3141,"Técnicos Mecânicos Na Fabricação E Montagem De Máquinas, Sistemas E Instrumentos",47591.4890674541,10110,75018,64908
7,Médio Completo,3142,Técnicos Mecânicos (Ferramentas),4892.9962434039635,91,3342,3251
7,Médio Completo,3143,Técnicos Em Mecânica Veicular,3151.5920470823844,1317,6780,5463
7,Médio Completo,3144,"Técnicos Mecânicos Na Manutenção De Máquinas, Sistemas E Instrumentos",2978.7287928052265,3456,30832,27376
7,Médio Completo,3146,Técnicos Em Metalurgia (Estruturas Metálicas),4082.9110142593136,-80,6864,6944
7,Médio Completo,3147,Técnicos Em Siderurgia,3267.8551634799437,396,1915,1519
7,Médio Completo,3148,Especialistas Em Inspeções Industriais,5876.897055056899,805,4213,3408
7,Médio Completo,3161,Técnicos Em Geologia,2316.5251621229363,477,1815,1338
7,Médio Completo,3163,Técnicos Em Mineração,3761.1186854338175,752,3458,2706
7,Médio Completo,3171,Técnicos De Desenvolvimento De Sistemas E Aplicações,3663.187241524055,7274,38824,31550
7,Médio Completo,3172,Técnicos De Suporte E Monitoração Ao Usuário De Tecnologia Da Informação.,1788.3896389334009,19611,97736,78125
7,Médio Completo,3180,"Desenhistas Técnicos, Em Geral",2712.456301389387,403,7281,6878
7,Médio Completo,3181,Desenhistas Técnicos Da Construção Civil E Arquitetura,2369.6222025229695,440,4420,3980
7,Médio Completo,3182,Desenhistas Técnicos Da Mecânica,3788.9072752188895,79,1829,1750
7,Médio Completo,3183,"Desenhistas Técnicos Em Eletricidade, Eletrônica, Eletromecânica, Calefação, Ventilação E Refrigeração",1913.063565939392,21,821,800
7,Médio Completo,3184,Desenhistas Técnicos De Produtos E Serviços Diversos,2104.0332863364947,146,8413,8267
7,Médio Completo,3185,Desenhistas Projetistas De Construção Civil E Arquitetura,2943.2220218530083,2717,12419,9702
7,Médio Completo,3186,Desenhistas Projetistas Da Mecânica,3748.9169106284803,980,8147,7167
7,Médio Completo,3187,Desenhistas Projetistas Da Eletrônica,4309.320485823644,284,3507,3223
7,Médio Completo,3188,Desenhistas Projetistas E Modelistas De Produtos E Serviços Diversos,3255.3525686543057,898,15405,14507
7,Médio Completo,3191,Técnicos Do Vestuário,3325.351095411795,-67,545,612
7,Médio Completo,3192,Técnicos Do Mobiliário E Afins,1913.2245942249017,72,580,508
7,Médio Completo,3201,Técnicos Em Biologia,1998.2054510799758,83,424,341
7,Médio Completo,3211,Técnicos Agrícolas,2358.1017302880878,2822,29786,26964
7,Médio Completo,3212,Técnicos Florestais,2073.4396642635256,785,5320,4535
7,Médio Completo,3213,Técnicos Em Aqüicultura,1681.9077260231627,94,393,299
7,Médio Completo,3221,Tecnólogos E Técnicos Em Terapias Complementares E Estéticas,1799.8842111241936,-476,27013,27489
7,Médio Completo,3222,Técnicos E Auxiliares De Enfermagem,2194.296012266137,151695,994806,843111
7,Médio Completo,3223,Técnicos Em Óptica E Optometria,1421.741461577777,88,2802,2714
7,Médio Completo,3224,Técnicos De Odontologia,1797.7752207362053,15187,117448,102261
7,Médio Completo,3225,Técnicos Em Próteses Ortopédicas,3775.6688588594134,-46,737,783
7,Médio Completo,3226,Técnicos De Imobilizações Ortopédicas,1869.0952551665246,470,3001,2531
7,Médio Completo,3231,Técnicos Em Pecuária,2955.4565846200376,70,416,346
7,Médio Completo,3241,Tecnólogos E Técnicos Em Métodos De Diagnósticos E Terapêutica,2569.959771898935,2717,26661,23944
7,Médio Completo,3242,Técnicos De Laboratórios De Saúde E Bancos De Sangue,1996.0299210344322,5016,39224,34208
7,Médio Completo,3250,"Enólogos, Perfumistas E Aromistas",2524.1264079384496,1050,6433,5383
7,Médio Completo,3251,Técnico Em Farmácia E Em Manipulação Farmacêutica,56710.374838695396,5404,26591,21187
7,Médio Completo,3252,"Técnicos Em Produção, Conservação  E De Qualidade De Alimentos",1982.7631350566378,1557,18238,16681
7,Médio Completo,3253,Técnicos De Apoio À Biotecnologia,2099.0644024909657,50,241,191
7,Médio Completo,3281,Técnicos Em Necrópsia E Taxidermistas,1739.0267828329052,52,256,204
7,Médio Completo,3311,Professores De Nível Médio Na Educação Infantil,1840.217778446487,34588,160140,125552
7,Médio Completo,3312,Professores De Nível Médio No Ensino Fundamental,3298.305146740031,268,14744,14476
7,Médio Completo,3313,Professores De Nível Médio No Ensino Profissionalizante,1752.2533726148436,-225,1457,1682
7,Médio Completo,3321,Professores Leigos No Ensino Fundamental,1597.8297387109606,329,3432,3103
7,Médio Completo,3322,Professores Práticos No Ensino Profissionalizante,1944.191137292071,-64,1197,1261
7,Médio Completo,3331,Instrutores E Professores De Cursos Livres,2716.970152330063,11055,101919,90864
7,Médio Completo,3341,Inspetores De Alunos E Afins,1702.8583599150325,24663,108706,84043
7,Médio Completo,3411,"Pilotos De Aviação Comercial, Mecânicos De Vôo E Afins",4146.019819182574,450,3268,2818
7,Médio Completo,3412,"Técnicos Marítimos, Fluviários E Pescadores De Convés",2580.443906459922,896,6480,5584
7,Médio Completo,3413,Técnicos Marítimos E Fluviários De Máquinas,2715.0125412086377,282,4006,3724
7,Médio Completo,3421,Especialistas Em Logística De Transportes,2225.117288159721,11800,103284,91484
7,Médio Completo,3422,Despachantes Aduaneiros,2724.8266114934263,487,4983,4496
7,Médio Completo,3423,Técnicos Em Transportes Rodoviários,2448.4569955745324,-3256,29933,33189
7,Médio Completo,3424,Técnicos Em Transportes Metroferroviários,2085.4702440758592,-688,4048,4736
7,Médio Completo,3425,Técnicos Em Transportes Aéreos,2587.281909774583,4520,28026,23506
7,Médio Completo,3426,Técnicos Em Transportes Por Vias Navegáveis E Operações Portuárias,2755.6191439930863,22,1900,1878
7,Médio Completo,3511,Técnicos Em Contabilidade,2762.1410486678233,-1188,3641,4829
7,Médio Completo,3513,Técnicos Em Administração,2232.734098289866,1571,17742,16171
7,Médio Completo,3514,Serventuários Da Justiça E Afins,2398.954139634918,2831,26515,23684
7,Médio Completo,3515,"Técnicos Em Secretariado, Taquígrafos E Estenotipistas",1811.0055874239742,1258,38866,37608
7,Médio Completo,3516,Técnicos Em Segurança Do Trabalho,3050.8793886012354,24163,195070,170907
7,Médio Completo,3517,Técnicos De Seguros E Afins,2063.905759947859,3089,33695,30606
7,Médio Completo,3518,Agentes De Investigação E Identificação,2174.0337409658946,-17,51,68
7,Médio Completo,3519,Técnicos Da Inteligência,2513.3247178792262,15,153,138
7,Médio Completo,3522,Agentes Da Saúde E Do Meio Ambiente,3205.2789580764047,2175,12844,10669
7,Médio Completo,3523,Agentes  Fiscais Metrológicos E De Qualidade,2559.6267079291597,93,9820,9727
7,Médio Completo,3524,Profissionais De Direitos Autorais E De Avaliacão De Produtos Dos Meios De Comunicação,2176.5071098317608,21,314,293
7,Médio Completo,3532,Técnicos Em Operações E Serviços Bancários,2522.785886386734,-1002,1689,2691
7,Médio Completo,3541,Especialistas Em Promoção De Produtos E Vendas,1918.8206750572795,64273,708717,644444
7,Médio Completo,3542,Compradores,2987.5463835503724,898,42290,41392
7,Médio Completo,3543,Analistas De Comércio Exterior,3530.2818175247908,125,3439,3314
7,Médio Completo,3544,Leiloeiros E Avaliadores,1741.8161593605525,274,3737,3463
7,Médio Completo,3545,Corretores De Seguros,1577.279023237938,219,2092,1873
7,Médio Completo,3546,Corretores De Imóveis E De Grãos,2195.5929934148517,420,4446,4026
7,Médio Completo,3547,Representantes Comerciais Autônomos,1734.6260279277685,107,5370,5263
7,Médio Completo,3548,Técnicos Em Serviços De Turismo E Organização De Eventos,2176.3122101505933,5731,33321,27590
7,Médio Completo,3711,Técnicos Em Biblioteconomia,2713.7618573162536,-446,3246,3692
7,Médio Completo,3712,Técnicos Em Museologia E Afins,1610.131852106314,-32,39,71
7,Médio Completo,3713,Técnicos Em Artes Gráficas,1881.023839210964,-112,1392,1504
7,Médio Completo,3714,Recreadores,1522.8003790946123,8588,63649,55061
7,Médio Completo,3721,Captadores De Imagens Em Movimento,2799.8269815592107,194,6511,6317
7,Médio Completo,3722,Operadores De Rede De Teleprocessamento E Afins,1975.2371263256584,4029,15623,11594
7,Médio Completo,3731,Técnicos De Operação De Registros Sonoro/Audiovisuais,2236.330353617849,456,9798,9342
7,Médio Completo,3732,Supervisores Operacionais E Técnicos Em Mídias Audiovisuais,3112.2667195517697,-954,2005,2959
7,Médio Completo,3741,Técnicos Em Áudio,2142.3490283760216,811,15508,14697
7,Médio Completo,3742,Técnicos Em Cenografia,2463.6419080646087,71,2104,2033
7,Médio Completo,3743,Técnicos Em Operação De Aparelhos De Projeção,2089.1175492273865,-107,650,757
7,Médio Completo,3744,"Técnicos Em Montagem, Edição E Finalização De Mídia Audiovisual",2489.4444909094304,939,13831,12892
7,Médio Completo,3751,"Designers De Interiores, De Vitrines E Visual Merchandiser E Afins (Nível Médio)",1919.7160372827955,-1671,17165,18836
7,Médio Completo,3761,Dançarinos Tradicionais E Populares,2519.604728754977,-38,142,180
7,Médio Completo,3762,Artistas De Circo (Circenses),2872.867963238903,-143,490,633
7,Médio Completo,3763,"Apresentadores De Eventos, Programas E Espetáculos",3286.4073737008207,163,2627,2464
7,Médio Completo,3764,Modelos,2161.7689419169233,-102,386,488
7,Médio Completo,3771,Atletas Profissionais,4514.428969454952,5791,48150,42359
7,Médio Completo,3772,Árbitros Desportivos,2881.6001079728926,11,173,162
7,Médio Completo,3911,"Planejadores, Programadores E Controladores De Produção E Manutenção",4200.384569558364,15494,175815,160321
7,Médio Completo,3912,Técnicos De Controle Da Produção,30162.694373405833,6894,179211,172317
7,Médio Completo,3951,Técnicos De Apoio Em Pesquisa E Desenvolvimento,5030.809049201604,-442,8728,9170
7,Médio Completo,4101,Supervisores Administrativos,3062.6807839403414,-33735,153423,187158
7,Médio Completo,4102,"Supervisores De Serviços Financeiros, De Câmbio E De Controle",2535.22956494795,-7841,48317,56158
7,Médio Completo,4110,"Agentes, Assistentes E Auxiliares Administrativos",2176.9606880780675,413141,3630552,3217411
7,Médio Completo,4121,Operadores De Equipamentos De Entrada E Transmissão De Dados,1603.8737036634825,142,25246,25104
7,Médio Completo,4122,Contínuos,1692.9491370215922,5682,155574,149892
7,Médio Completo,4131,Auxiliares De Contabilidade,2152.914658961317,14879,180448,165569
7,Médio Completo,4132,Escriturários De Serviços Bancários,1997.5515349053876,13273,72290,59017
7,Médio Completo,4141,Almoxarifes E Armazenistas,1851.0048325257987,371134,2317681,1946547
7,Médio Completo,4142,Apontadores E Conferentes,2253.8295593407515,-5058,259448,264506
7,Médio Completo,4151,"Auxiliares De Serviços De Documentação, Informação E Pesquisa",1552.0670211398226,1530,23259,21729
7,Médio Completo,4152,"Trabalhadores Nos Serviços De Classificação E Entregas De Correspondências, Encomendas E Publicações",1773.2491085809645,-4949,36703,41652
7,Médio Completo,4153,Trabalhadores Em Registros E Informações Em Saúde,2154.07363059304,5,8,3
7,Médio Completo,4201,Supervisores De Atendimento Ao Público E De Pesquisa,2077.467986322454,-17728,39552,57280
7,Médio Completo,4211,Caixas E Bilheteiros (Exceto Caixa De Banco),1735.2596929887666,147144,2089604,1942460
7,Médio Completo,4212,Coletadores De Apostas E De Jogos,1365.620586349336,-381,35480,35861
7,Médio Completo,4213,Cobradores E Afins,1658.2593878199968,8541,179090,170549
7,Médio Completo,4221,Recepcionistas,1779.0741891951395,180441,1291239,1110798
7,Médio Completo,4222,Operadores De Telefonia,1867.1712681759986,-193,61306,61499
7,Médio Completo,4223,Operadores De Telemarketing E Afins,1395.944842862201,58427,1255712,1197285
7,Médio Completo,4231,Despachantes Documentalistas E Afins,2048.2010231188538,2018,11527,9509
7,Médio Completo,4241,Entrevistadores E Recenseadores,1584.6822372150646,827,19178,18351
7,Médio Completo,4242,Aplicadores De Provas E Afins,1732.3671375667316,51,175,124
7,Médio Completo,5101,"Supervisores Dos Serviços De Transporte, Turismo, Hotelaria E Administração De Edifícios",2518.454623422564,-4813,31666,36479
7,Médio Completo,5102,Supervisores De Lavanderia,1988.627765165427,-599,2201,2800
7,Médio Completo,5103,"Supervisores Dos Serviços De Proteção, Segurança E Outros",2720.2152294540983,-2614,11758,14372
7,Médio Completo,5111,Trabalhadores De Segurança E Atendimento Aos Usuários Nos Transportes,1833.9637575162626,-156,6453,6609
7,Médio Completo,5112,Fiscais E Cobradores Dos Transportes Coletivos,1502.249860341749,-27796,66914,94710
7,Médio Completo,5114,Guias De Turismo,1715.862017679237,73,1096,1023
7,Médio Completo,5115,Condutores De Turismo,1860.8136462396471,165,589,424
7,Médio Completo,5121,Trabalhadores Dos Serviços Domésticos Em Geral,1501.299225941705,11060,37795,26735
7,Médio Completo,5131,Mordomos E Governantas,1660.9344351168995,160,8872,8712
7,Médio Completo,5132,Cozinheiros,1766.3121082265484,32631,653023,620392
7,Médio Completo,5133,"Camareiros, Roupeiros E Afins",1548.0675228601808,15696,173498,157802
7,Médio Completo,5134,"Trabalhadores No Atendimento Em Estabelecimentos De Serviços De Alimentação, Bebidas E Hotelaria",2415.3966613272796,136300,1783099,1646799
7,Médio Completo,5135,Trabalhadores Auxiliares Nos Serviços De Alimentação,1790.9450164569776,135814,989075,853261
7,Médio Completo,5136,"Churrasqueiros, Pizzaiolos E Sushimen",1773.5670538969746,7071,105766,98695
7,Médio Completo,5141,Trabalhadores Nos Serviços De Administração De Edifícios,1697.9048230882888,31401,294225,262824
7,Médio Completo,5142,"Trabalhadores Nos Serviços De Coleta De Resíduos, De Limpeza E Conservação De Áreas Públicas",1473.6777195168256,65819,472787,406968
7,Médio Completo,5143,Trabalhadores Nos  Serviços De Manutenção De Edificações,2248.2229424269076,448084,2877260,2429176
7,Médio Completo,5151,Trabalhadores Em Serviços De Promoção E Apoio À Saúde,1762.3754750804248,24323,85863,61540
7,Médio Completo,5152,Auxiliares De Laboratório Da Saúde,6808.80746249184,26538,141109,114571
7,Médio Completo,5153,"Trabalhadores De Atenção, Defesa E Proteção A Pessoas Em Situação De Risco E Adolescentes Em Conflito Com A Lei",1715.7394648859502,12971,56073,43102
7,Médio Completo,5161,Trabalhadores Nos Serviços De Embelezamento E Higiene,1761.7581266376337,-9146,23149,32295
7,Médio Completo,5162,"Cuidadores De Crianças, Jovens, Adultos E Idosos",2479.1860381223814,38549,168401,129852
7,Médio Completo,5163,"Tintureiros, Lavadeiros E Afins, A Máquina",1754.5740195692824,10955,112289,101334
7,Médio Completo,5164,"Lavadores E Passadores De Roupa, A Mão",1390.783818007155,108,6996,6888
7,Médio Completo,5165,Trabalhadores Dos Serviços Funerários,1610.5050188460734,2643,18720,16077
7,Médio Completo,5166,Trabalhadores Auxiliares Dos Serviços Funerários,1530.4672503959778,980,3773,2793
7,Médio Completo,5167,Astrólogos E Numerólogos,1700,1,2,1
7,Médio Completo,5168,Esotéricos E Paranormais,2050.1486811319987,-5,6,11
7,Médio Completo,5169,Trabalhadores Nos Serviços De Arte Corporal,1817.1472612072173,10,27,17
7,Médio Completo,5171,"Bombeiros, Salva-Vidas E Afins",1969.378986401827,10510,56284,45774
7,Médio Completo,5172,"Policiais, Guardas-Civis Municipais E Agentes De Trânsito",1968.2551438778567,643,9932,9289
7,Médio Completo,5173,Vigilantes E Guardas De Segurança,2238.8039563436146,67818,699467,631649
7,Médio Completo,5174,"Porteiros, Vigias E Afins",1787.4944739065497,148794,1224908,1076114
7,Médio Completo,5191,Motociclistas E Ciclistas De Entregas Rápidas,1708.8180656858647,30107,303751,273644
7,Médio Completo,5192,Trabalhadores Da Coleta E Seleção De Material Reciclável,1568.058293252091,4853,30724,25871
7,Médio Completo,5193,"Trabalhadores De Serviços Veterinários, De Higiene E Estética De Animais Domésticos",1631.6243856837777,9580,73251,63671
7,Médio Completo,5198,Profissionais Do Sexo,1407.9493489583333,5,10,5
7,Médio Completo,5199,Outros Trabalhadores Dos Serviços,1551.3447065971072,21279,235429,214150
7,Médio Completo,5201,Supervisores De Vendas E De Prestação De Serviços,2354.085775606074,-20972,88256,109228
7,Médio Completo,5211,Operadores Do Comércio Em Lojas E Mercados,32772.023395904565,677867,8207075,7529208
7,Médio Completo,5231,Instaladores De Produtos E Acessórios,1660.5574990674736,2182,29640,27458
7,Médio Completo,5241,Vendedores Em Domicílio,124219.75078507494,4961,132692,127731
7,Médio Completo,5242,"Vendedores Em Bancas, Quiosques E Barracas",1353.6840372352606,181,6559,6378
7,Médio Completo,5243,Vendedores Ambulantes,1368.7546794886155,110,9403,9293
7,Médio Completo,6110,Produtores Agropecuários Em Geral,1721.490737166442,605,3574,2969
7,Médio Completo,6120,Produtores Agrícolas Polivalentes,1500.3280672957276,758,3388,2630
7,Médio Completo,6121,Produtores Agrícolas Na Cultura De Gramíneas,1497.2395082372655,159,858,699
7,Médio Completo,6122,Produtores Agrícolas Na Cultura De Plantas Fibrosas,1516,0,7,7
7,Médio Completo,6123,Produtores Agrícolas Na Olericultura,1368.856566406107,-72,451,523
7,Médio Completo,6124,Produtores Agrícolas No Cultivo De Flores E Plantas Ornamentais,1573.7461808649405,38,324,286
7,Médio Completo,6125,Produtores Agrícolas Na Fruticultura,1188.8889917229515,127,1099,972
7,Médio Completo,6126,Produtores Agrícolas Na Cultura De Plantas Estimulantes,2065.091121321348,18,43,25
7,Médio Completo,6127,Produtores Agrícolas Na Cultura De Plantas Oleaginosas,1530.8755450732376,11,92,81
7,Médio Completo,6128,Produtores De Especiarias E De Plantas Aromáticas E Medicinais,1646.0287216186523,12,30,18
7,Médio Completo,6130,Produtores Em Pecuária Polivalente,1430.598966065558,89,713,624
7,Médio Completo,6131,Produtores Em Pecuária De Animais De Grande Porte,1521.927133444725,188,1378,1190
7,Médio Completo,6132,Produtores Em Pecuária De Animais De Médio Porte,1624.9942211456485,75,637,562
7,Médio Completo,6133,Produtores Da Avicultura E Cunicultura,1679.725199750451,586,3885,3299
7,Médio Completo,6134,Produtores De Animais E Insetos Úteis,1619.372186501883,4,174,170
7,Médio Completo,6201,Supervisores Na Exploração Agropecuária,3031.0816631638977,1391,26641,25250
7,Médio Completo,6210,Trabalhadores Agropecuários Em Geral,1560.0658758954514,51135,370713,319578
7,Médio Completo,6220,Trabalhadores De Apoio À Agricultura,1968.045534619896,50284,398800,348516
7,Médio Completo,6221,Trabalhadores Agrícolas Na Cultura De Gramíneas,2206.1799454164357,5285,110822,105537
7,Médio Completo,6222,Trabalhadores Agrícolas Na Cultura De Plantas Fibrosas,1454.604369841193,136,1438,1302
7,Médio Completo,6223,Trabalhadores Agrícolas Na Olericultura,1352.1500272027895,1540,16289,14749
7,Médio Completo,6224,Trabalhadores Agrícolas No Cultivo De Flores E Plantas Ornamentais,1546.881689781251,1706,14822,13116
7,Médio Completo,6225,Trabalhadores Agrícolas Na Fruticultura,2581.3000590604593,4410,121972,117562
7,Médio Completo,6226,Trabalhadores Agrícolas Nas Culturas De Plantas Estimulantes,1236.059733448781,1506,35310,33804
7,Médio Completo,6227,Trabalhadores Agrícolas Na Cultura De Plantas Oleaginosas,1741.5912656844398,2756,10547,7791
7,Médio Completo,6228,Trabalhadores Agrícolas Da Cultura De Especiarias E De Plantas Aromáticas E Medicinais,1140.1768801757373,214,1133,919
7,Médio Completo,6230,Tratadores Polivalentes De Animais,1763.6931980681513,6447,42841,36394
7,Médio Completo,6231,Trabalhadores Na Pecuária De Animais De Grande Porte,1716.52582935643,13263,105020,91757
7,Médio Completo,6232,Trabalhadores Na Pecuária De Animais De Médio Porte,1389.5054676021384,2294,20698,18404
7,Médio Completo,6233,Trabalhadores Na Avicultura E Cunicultura,1411.7488993704742,7857,71427,63570
7,Médio Completo,6234,Trabalhadores Na Criação De Insetos E Animais Úteis,1471.2688110129343,44,1327,1283
7,Médio Completo,6301,Supervisores Na Área Florestal E Aqüicultura,2403.3943347989284,80,5783,5703
7,Médio Completo,6310,Pescadores Polivalentes,1468.8111090486364,38,660,622
7,Médio Completo,6311,Pescadores Profissionais Artesanais De Água Doce,1572.3676315048995,21,158,137
7,Médio Completo,6312,Pescadores De Água Costeira E Alto Mar,1905.265487907136,452,7961,7509
7,Médio Completo,6313,Criadores De Animais Aquáticos,1507.8124217751456,1471,6406,4935
7,Médio Completo,6314,Trabalhadores De Apoio À Pesca,1420.4239914775803,75,534,459
7,Médio Completo,6320,Trabalhadores Florestais Polivalentes,1719.0812263118085,1161,4775,3614
7,Médio Completo,6321,Extrativistas E Reflorestadores De Espécies Produtoras De Madeira,1537.3375666525733,7282,77996,70714
7,Médio Completo,6322,Extrativistas Florestais De Espécies Produtoras De Gomas E Resinas,3930.6681770299124,-316,8431,8747
7,Médio Completo,6323,"Extrativistas Florestais De Espécies Produtoras De Fibras, Ceras E Óleos",1589.142179284012,137,1810,1673
7,Médio Completo,6324,Extrativistas Florestais De Espécies Produtoras De Alimentos Silvestres,1861.6865682134382,58,1730,1672
7,Médio Completo,6325,"Extrativistas Florestais De Espécies Produtoras De Substâncias Aromáticas, Medicinais E Tóxicas",1429.0737784430107,86,903,817
7,Médio Completo,6326,Carvoejadores,1893.828647210198,1679,13385,11706
7,Médio Completo,6410,Trabalhadores Da Mecanização Agrícola,4991.789816962837,36092,259866,223774
7,Médio Completo,6420,Trabalhadores Da Mecanização Florestal,2054.25336291199,3655,23266,19611
7,Médio Completo,6430,Trabalhadores Da Irrigação E Drenagem,1975.5708777106101,1109,6337,5228
7,Médio Completo,7101,Supervisores Da Extração Mineral,3925.128231798819,-340,3351,3691
7,Médio Completo,7102,Supervisores Da Construção Civil,3555.6460491457265,10619,142217,131598
7,Médio Completo,7111,Trabalhadores Da Extração De Minerais Sólidos,3536.3640452736286,5509,26418,20909
7,Médio Completo,7112,Trabalhadores De Extração De Minerais Sólidos (Operadores De Máquinas),2882.510073729674,5790,43293,37503
7,Médio Completo,7113,Trabalhadores Da Extração De Minerais Líquidos E Gasosos,2035.335745052249,3084,20103,17019
7,Médio Completo,7114,Garimpeiros E Operadores De Salinas,1371.151029803429,164,682,518
7,Médio Completo,7121,Trabalhadores De Beneficiamento De Minérios,2020.0687606279764,1824,9561,7737
7,Médio Completo,7122,Trabalhadores De Beneficiamento De Pedras Ornamentais,1960.2652700855813,3211,28372,25161
7,Médio Completo,7151,Trabalhadores Na Operação De Máquinas De Terraplenagem E Fundações,2613.1913154529116,29219,234406,205187
7,Médio Completo,7152,Trabalhadores De Estruturas De Alvenaria,2480.184676873308,70834,681015,610181
7,Médio Completo,7153,Montadores De Estruturas De Concreto Armado,2371.906115094991,11769,118601,106832
7,Médio Completo,7154,Trabalhadores Na Operação De Máquinas De Concreto Usinado E Afins,2181.3453531881273,2300,27333,25033
7,Médio Completo,7155,"Trabalhadores De Montagem De Estruturas De Madeira, Metal E Compósitos Em Obras Civis",25778.723815546473,26087,292436,266349
7,Médio Completo,7156,Trabalhadores De Instalações Elétricas,2773.1950062470182,37466,303470,266004
7,Médio Completo,7157,Aplicadores De Materiais Isolantes,3003.157960126144,2427,28648,26221
7,Médio Completo,7161,Revestidores De Concreto,2013.556441281701,510,4997,4487
7,Médio Completo,7162,Telhadores (Revestimentos Rígidos),2201.0627567848014,211,2046,1835
7,Médio Completo,7163,Vidraceiros (Revestimentos Rígidos),1671.9953769658393,3909,39215,35306
7,Médio Completo,7164,Gesseiros,2333.3445889513378,5689,48389,42700
7,Médio Completo,7165,"Aplicadores De Revestimentos Cerâmicos, Pastilhas, Pedras E Madeiras",1978.6575557528054,6049,47092,41043
7,Médio Completo,7166,Pintores De Obras E Revestidores De Interiores (Revestimentos Flexíveis),2202.199045055939,15475,158050,142575
7,Médio Completo,7170,Ajudantes De Obras Civis,3470.520863383662,236698,1597318,1360620
7,Médio Completo,7201,"Supervisores De Usinagem, Conformação E Tratamento De Metais",4345.633036646009,-173,18498,18671
7,Médio Completo,7202,Supervisores Da Fabricação E Montagem Metalmecânica,4936.012186994315,-2356,4154,6510
7,Médio Completo,7211,Ferramenteiros E Afins,5931.431543318919,-760,19702,20462
7,Médio Completo,7212,Preparadores E Operadores De Máquinas-Ferramenta Convencionais,3551.153484105237,10523,152914,142391
7,Médio Completo,7213,Afiadores E Polidores De Metais,2130.4438133366166,1726,21771,20045
7,Médio Completo,7214,Operadores De Máquinas De Usinagem Cnc,5433.2359643733425,3219,51044,47825
7,Médio Completo,7221,Trabalhadores De Forjamento De Metais,1901.641767817696,455,10286,9831
7,Médio Completo,7222,Trabalhadores De Fundição De Metais Puros E De Ligas Metálicas,4774.853778856732,3873,33664,29791
7,Médio Completo,7223,Trabalhadores De Moldagem De Metais E De Ligas Metálicas,2370.6623940938084,1378,13276,11898
7,Médio Completo,7224,Trabalhadores De Trefilação E Estiramento De Metais Puros E Ligas Metálicas,2763.5074266574434,248,4710,4462
7,Médio Completo,7231,Trabalhadores De Tratamento Térmico De Metais,2398.7431647918265,403,4552,4149
7,Médio Completo,7232,Trabalhadores De Tratamento De Superfícies De Metais E De Compósitos (Termoquímicos),2250.793671848833,272,11434,11162
7,Médio Completo,7233,"Trabalhadores Da Pintura De Equipamentos, Veículos, Estruturas Metálicas E De Compósitos",17370.822869432664,8535,105039,96504
7,Médio Completo,7241,Encanadores E Instaladores De Tubulações,2661.42407592628,14129,152325,138196
7,Médio Completo,7242,Trabalhadores De Traçagem E Montagem De Estruturas Metálicas E De Compósitos,3086.5098938126307,36510,239733,203223
7,Médio Completo,7243,Trabalhadores De Soldagem E Corte De Ligas Metálicas,3666.164447877315,34801,365613,330812
7,Médio Completo,7244,Trabalhadores De Caldeiraria E Serralheria,3928.8847415992395,26833,279056,252223
7,Médio Completo,7245,Operadores De Máquinas De Conformação De Metais,3289.5059162731372,1519,38348,36829
7,Médio Completo,7246,Trançadores E Laceiros De Cabos De Aço,1888.3035506424385,13,1292,1279
7,Médio Completo,7250,Ajustadores Mecânicos Polivalentes E Afins,4498266.350200242,8258,54257,45999
7,Médio Completo,7251,"Montadores De Máquinas, Aparelhos E Acessórios Em Linhas De Montagem",3381.8496686029225,4839,50980,46141
7,Médio Completo,7252,Montadores De Máquinas Industriais,3012.9365775582855,10565,100910,90345
7,Médio Completo,7253,Montadores De Máquinas Pesadas E Equipamentos Agrícolas,2632.282366472765,1818,10077,8259
7,Médio Completo,7254,Mecânicos Montadores De Motores E Turboalimentadores,2353.0639074618703,843,6700,5857
7,Médio Completo,7255,Montadores De Veículos Automotores (Linha De Montagem),29695.611383073207,1015,33277,32262
7,Médio Completo,7256,Montadores De Sistemas E Estruturas De Aeronaves,2401.9737367042685,-136,860,996
7,Médio Completo,7257,Instaladores De Equipamentos De Refrigeração E Ventilação,2532.013233216221,2059,30659,28600
7,Médio Completo,7301,Supervisores De Montagens E Instalações Eletroeletrônicas,6589.948372528388,-757,6104,6861
7,Médio Completo,7311,Montadores De Equipamentos Eletroeletrônicos,2395.8599693507003,28209,239248,211039
7,Médio Completo,7312,Montadores De Aparelhos De Telecomunicações,1423.8430237428827,-245,6885,7130
7,Médio Completo,7313,Instaladores-Reparadores De  Linhas E Equipamentos De Telecomunicações,3669.617188654606,-2442,70432,72874
7,Médio Completo,7321,"Instaladores E Reparadores De Linhas E Cabos Elétricos, Telefônicos E De Comunicação De Dados",2718.146866568437,36745,229504,192759
7,Médio Completo,7401,Supervisores Da Mecânica De Precisão E Instrumentos Musicais,4504.885556315225,-25,547,572
7,Médio Completo,7411,Mecânicos De Instrumentos De Precisão,2247.562879071666,301,12259,11958
7,Médio Completo,7421,Confeccionadores De Instrumentos Musicais,1775.0523665926137,45,647,602
7,Médio Completo,7501,Supervisores De Joalheria E Afins,2436.8171449729375,-10,100,110
7,Médio Completo,7502,"Supervisores De Vidraria, Cerâmica E Afins",4236.9374429980035,-34,437,471
7,Médio Completo,7510,Joalheiros E Lapidadores De Gemas,1671.2014704414855,45,3160,3115
7,Médio Completo,7511,Artesãos De Metais Preciosos E Semi-Preciosos,2465.109759314267,391,6565,6174
7,Médio Completo,7521,"Sopradores, Moldadores E Modeladores De Vidros E Afins",2294.475810046577,59,975,916
7,Médio Completo,7522,Trabalhadores Da Transformação De Vidros Planos,1814.4340085885979,-166,7859,8025
7,Médio Completo,7523,Ceramistas (Preparação E Fabricação),1914.322292671306,3922,35258,31336
7,Médio Completo,7524,Vidreiros E Ceramistas (Arte E Decoração),1677.9617630187543,-63,2195,2258
7,Médio Completo,7601,Supervisores Da Indústria Têxtil,5923.625785689831,-30,10962,10992
7,Médio Completo,7602,Supervisores Na Indústria Do Curtimento,4099.999029159546,-28,74,102
7,Médio Completo,7603,Supervisores Na Confecção Do Vestuário,2379.1724488325517,-2090,8336,10426
7,Médio Completo,7604,Supervisores Na Confecção De Calçados,3057.050366872946,-1160,4734,5894
7,Médio Completo,7605,"Supervisores Da Confecção De Artefatos De Tecidos, Couros E Afins",3013.4464193642743,-314,1724,2038
7,Médio Completo,7606,Supervisores Das Artes Gráficas,2872.923309801793,-518,1506,2024
7,Médio Completo,7610,Trabalhadores Polivalentes Das Indústrias Têxteis,2876.562345152612,4440,38481,34041
7,Médio Completo,7611,Trabalhadores Da Classificação De Fibras Têxteis E Lavagem De Lã,1589.1879228265593,173,1765,1592
7,Médio Completo,7612,Operadores Da Fiação,2000.860833485239,-294,12013,12307
7,Médio Completo,7613,Operadores De Tear E Máquinas Similares,2386.722664769612,334,30783,30449
7,Médio Completo,7614,"Trabalhadores De Acabamento, Tingimento E Estamparia Das Indústrias Têxteis",3006.1352075003806,510,21147,20637
7,Médio Completo,7618,Inspetores E Revisores De Produção Têxtil,1974.170023131065,1424,34478,33054
7,Médio Completo,7620,Trabalhadores Polivalentes Do Curtimento De Couros E Peles,2621.2322205830756,718,8759,8041
7,Médio Completo,7621,Trabalhadores Da Preparação Do Curtimento De Couros E Peles,6786.267895559817,-103,730,833
7,Médio Completo,7622,Trabalhadores Do Curtimento De Couros E Peles,1694.2470903263618,-136,2750,2886
7,Médio Completo,7623,Trabalhadores Do Acabamento De Couros E Peles,1854.9959165131913,-183,3031,3214
7,Médio Completo,7630,Profissionais Polivalentes Da Confecção De Roupas,2513.2675552933633,1277,50383,49106
7,Médio Completo,7631,Trabalhadores Da Preparação Da Confecção De Roupas,523070.0849060678,22694,195602,172908
7,Médio Completo,7632,Operadores De Máquinas Para Costura De Peças Do Vestuário,3742.8234205003205,5208,325690,320482
7,Médio Completo,7633,Operadores De Máquinas Para Bordado E Acabamento De Roupas,1719.5626921023534,2426,53268,50842
7,Médio Completo,7640,Trabalhadores Polivalentes Da Confecção De Calçados,1386.3092747865082,14030,105867,91837
7,Médio Completo,7641,Trabalhadores Da Preparação Da Confecção De Calçados,1607.0918045839217,5216,65883,60667
7,Médio Completo,7642,Operadores De Máquinas De Costurar E Montar Calçados,1590.6101594803822,-1255,33259,34514
7,Médio Completo,7643,Trabalhadores De Acabamento De Calçados,1685.7859066919625,-227,16767,16994
7,Médio Completo,7650,Trabalhadores Polivalentes Da Confecção De Artefatos De Tecidos E Couros,1458.5637466923565,73,1474,1401
7,Médio Completo,7651,"Trabalhadores Da Preparação De Artefatos De Tecidos, Couros E Tapeçaria",1981.712221332261,70,4788,4718
7,Médio Completo,7652,"Trabalhadores Da Confecção De Artefatos De Tecidos, Couros E Sintéticos",1871.5908392789331,1020,22089,21069
7,Médio Completo,7653,Operadores De Máquinas Na Confecção De Artefatos De  Couro,1663.037150739974,240,4281,4041
7,Médio Completo,7654,Trabalhadores Do Acabamento De Artefatos De Tecidos E Couros,1614.7732922815858,374,5887,5513
7,Médio Completo,7661,Trabalhadores Da Pré-Impressão Gráfica,1935.0871298514055,-1132,17579,18711
7,Médio Completo,7662,Trabalhadores Da Impressão Gráfica,2198.0431451913214,-1638,41869,43507
7,Médio Completo,7663,Trabalhadores Do Acabamento Gráfico,2098.0177401034152,2062,47955,45893
7,Médio Completo,7664,Trabalhadores De Laboratório Fotográfico E Radiológico,1664.224616399567,-304,2713,3017
7,Médio Completo,7681,"Trabalhadores De Tecelagem Manual, Tricô, Crochê, Rendas E Afins",1726.449372611855,183,2290,2107
7,Médio Completo,7682,Trabalhadores Artesanais Da Confecção De Peças E Tecidos,1699.9851157719363,-84,1866,1950
7,Médio Completo,7683,Trabalhadores Artesanais Da Confecção De Calçados E Artefatos De Couros E Peles,6423.957451195591,1486,18295,16809
7,Médio Completo,7686,Trabalhadores Tipográficos Linotipistas E Afins,2838.2622009947604,-208,1846,2054
7,Médio Completo,7687,Encadernadores E Recuperadores De Livros (Pequenos Lotes Ou A Unidade),1566.3755044457957,-215,839,1054
7,Médio Completo,7701,"Supervisores Em Indústria De Madeira, Mobiliário E Da Carpintaria Veicular",3123.6959522299926,-512,5770,6282
7,Médio Completo,7711,Marceneiros E Afins,1986.40713500111,11634,105665,94031
7,Médio Completo,7721,Trabalhadores De Tratamento E Preparação Da Madeira,1684.097247187173,1913,19935,18022
7,Médio Completo,7731,Operadores De Máquinas De Desdobramento Da Madeira,1845.7955006846576,654,28506,27852
7,Médio Completo,7732,Operadores De Máquinas De Aglomeração E Prensagem De Chapas,1718.9886906354461,-47,1942,1989
7,Médio Completo,7733,Operadores De Usinagem Convencional De Madeira,2378.9998197617697,-156,21815,21971
7,Médio Completo,7734,Operadores De Máquina De Usinar Madeira (Produção Em Série),1792.1869475533201,-368,5645,6013
7,Médio Completo,7735,Operadores De Máquinas De Usinagem De Madeira Cnc,2449.91712322878,-445,3770,4215
7,Médio Completo,7741,Montadores De Móveis E Artefatos De Madeira,2116.564829950739,4620,87785,83165
7,Médio Completo,7751,Trabalhadores De Arte E  Do Acabamento Em Madeira Do Mobiliário,1674.0092307344999,404,4706,4302
7,Médio Completo,7764,"Confeccionadores De Artefatos De Madeira, Móveis De Vime E Afins",1607.701468569075,92,2096,2004
7,Médio Completo,7771,Carpinteiros Navais,2687.2285066990244,65,442,377
7,Médio Completo,7772,Carpinteiros De Carrocerias E Carretas,1675.1310580652398,37,601,564
7,Médio Completo,7801,Supervisores De Trabalhadores De Embalagem E Etiquetagem,2459.73007578896,-726,2939,3665
7,Médio Completo,7811,Condutores De Processos Robotizados,2786.4329627848424,-231,1114,1345
7,Médio Completo,7813,Operadores De Equipamentos Pilotados Remotamente,3108.170419758585,1268,2923,1655
7,Médio Completo,7817,Trabalhadores Subaquáticos,3357.6363046156657,241,3520,3279
7,Médio Completo,7821,Operadores De Máquinas E Equipamentos De Elevação,3027.3626640058333,4980,55157,50177
7,Médio Completo,7822,Operadores De Equipamentos De Movimentação De Cargas,2183.631458913886,592,185069,184477
7,Médio Completo,7823,Motoristas De Veículos De Pequeno E Médio Porte,2102.549311710659,50155,562768,512613
7,Médio Completo,7824,"Motoristas De Ônibus Urbanos, Metropolitanos E Rodoviários",2382.1232478009692,3618,249950,246332
7,Médio Completo,7825,Motoristas De Veículos De Cargas Em Geral,2455.2645386260047,188469,1541977,1353508
7,Médio Completo,7826,Operadores De Veículos Sobre Trilhos E Cabos Aéreos,2305.8084993135762,-341,3089,3430
7,Médio Completo,7827,Trabalhadores Aquaviários,2004.0739644360176,4671,26180,21509
7,Médio Completo,7828,Condutores De Animais E De Veículos De Tração Animal E Pedais,1634.1141426927954,345,3253,2908
7,Médio Completo,7831,Trabalhadores De Manobras De Transportes Sobre Trilhos,2611.2180329466546,2549,20543,17994
7,Médio Completo,7832,Trabalhadores De Cargas E Descargas De Mercadorias,1672.6196732576898,155194,1019778,864584
7,Médio Completo,7841,Trabalhadores De Embalagem E De Etiquetagem,1883.7978472405011,62100,471001,408901
7,Médio Completo,7842,Alimentadores De Linhas De Produção,2249.7945317505446,469677,2786863,2317186
7,Médio Completo,7911,Artesãos,2037.8596877286338,491,2728,2237
7,Médio Completo,8101,"Supervisores De Produção Em Indústrias Químicas, Petroquímicas E Afins",4025.7259121907114,-593,1901,2494
7,Médio Completo,8102,Supervisores De Produção Em Indústrias De Transformação De Plásticos E Borrachas,3797.846769560946,-740,2346,3086
7,Médio Completo,8103,"Supervisores De Produção Em Indústrias De Produtos Farmacêuticos, Cosméticos E Afins",3834.243866724433,-221,393,614
7,Médio Completo,8110,"Operadores Polivalentes De Equipamentos Em Indústrias Químicas, Petroquímicas E Afins",2198.035302395142,734,7348,6614
7,Médio Completo,8111,Operadores De Equipamentos De Moagem E Mistura De Materiais (Tratamentos Químicos E Afins),1888.070194629105,717,12135,11418
7,Médio Completo,8112,Operadores De Calcinação E De Tratamentos Químicos De Materiais Radioativos,2327.8553070170815,55,755,700
7,Médio Completo,8113,Operadores De Equipamentos De Filtragem E Separação,4665.648071188863,-1881,3793,5674
7,Médio Completo,8114,"Operadores De Equipamentos De Destilação, Evaporação E Reação",6909.344784633376,46,3690,3644
7,Médio Completo,8115,Operadores De Equipamentos De Produção E Refino De Petróleo E Gás,2328.1153302633247,449,1595,1146
7,Médio Completo,8116,Operadores De Equipamentos De Coqueificação,2154.1832612193352,218,3038,2820
7,Médio Completo,8117,"Operadores De Instalações E Máquinas De Produtos Plásticos, De Borracha E Moldadores De Parafinas",2113.6654894980356,4302,91139,86837
7,Médio Completo,8118,"Operadores De Máquinas E Instalações De Produtos Farmacêuticos, Cosméticos E Afins",1867.1029260658602,354,19433,19079
7,Médio Completo,8121,Trabalhadores Da Fabricação De Munição E Explosivos Químicos,1521.4274199642227,114,993,879
7,Médio Completo,8131,"Operadores De Processos Das Indústrias De Transformação De Produtos Químicos, Petroquímicos E Afins",3408.6770218552324,6482,86422,79940
7,Médio Completo,8181,Laboratoristas Industriais Auxiliares,2679.4859051581725,6107,33071,26964
7,Médio Completo,8201,Supervisores De Produção Em Indústrias Siderúrgicas,3952.160001764832,-193,1089,1282
7,Médio Completo,8202,Supervisores Na Fabricação De Materiais Para Construção (Vidros E Cerâmicas),3681.890722337183,-466,2199,2665
7,Médio Completo,8211,Operadores De Instalações De Sinterização,1852.5935872324744,350,3275,2925
7,Médio Completo,8212,Operadores De Fornos De Primeira  Fusão E Aciaria,2250.2437865293136,1008,14719,13711
7,Médio Completo,8213,Operadores De Equipamentos De Laminação,2158.942057309329,592,9028,8436
7,Médio Completo,8214,Operadores De Equipamentos De Acabamento De Chapas E Metais,3687.698676369067,5006,58240,53234
7,Médio Completo,8221,Forneiros Metalúrgicos (Segunda Fusão E Reaquecimento),2034.591809802249,-145,2485,2630
7,Médio Completo,8231,"Operadores Na Preparação De Massas Para Abrasivo, Vidro, Cerâmica, Porcelana E Materiais De Construção",2209.9117746943803,-224,2508,2732
7,Médio Completo,8232,"Operadores De Equipamentos De Fabricação  E Beneficiamento De Cristais, Vidros, Cerâmicas, Porcelanas, Fibras De Vidro, Abrasivos E Afins",2453.8259332560347,535,7546,7011
7,Médio Completo,8233,Operadores De Instalações E Equipamentos De Fabricação De Materiais De Construção,1759.0898356498196,4985,34616,29631
7,Médio Completo,8281,Trabalhadores Da Fabricação De Cerâmica Estrutural Para Construção,1483.5287855045199,3289,30126,26837
7,Médio Completo,8301,Supervisores Da Fabricação De Celulose E Papel,5524.910173403514,-424,619,1043
7,Médio Completo,8311,Preparadores De Pasta Para Fabricação De Papel,2656.6760451411883,94,2079,1985
7,Médio Completo,8321,Operadores De Máquinas De Fabricar Papel E Papelão,2814.2549340290275,-422,11817,12239
7,Médio Completo,8331,Operadores De Máquinas Na Fabricação De Produtos De Papel E Papelão,1862.5599316955595,585,12392,11807
7,Médio Completo,8332,Trabalhadores Artesanais De Produtos De Papel E Papelão,1940.2625259209685,456,3448,2992
7,Médio Completo,8401,"Supervisores Da Fabricação De Alimentos, Bebidas E Fumo",3122.3999528728555,-2252,10276,12528
7,Médio Completo,8411,"Trabalhadores Da Indústria De Beneficiamento De Grãos, Cereais E Afins",1799.598585178225,11,7356,7345
7,Médio Completo,8412,Trabalhadores No Beneficiamento Do Sal,909.2733172422643,419,1535,1116
7,Médio Completo,8413,Trabalhadores Na Fabricação E Refino De Açúcar,9884.267417566789,498,7823,7325
7,Médio Completo,8414,Trabalhadores Na Fabricação E Conservação De Alimentos,1706.2186786197053,2551,82775,80224
7,Médio Completo,8415,Trabalhadores Na Pasteurização Do Leite E Na Fabricação De Laticínios  E Afins,1507.989579871337,2356,26322,23966
7,Médio Completo,8416,"Trabalhadores Na Industrialização De Café, Cacau, Mate E De Produtos Afins",1556.0884116046248,-155,983,1138
7,Médio Completo,8417,"Trabalhadores Na Fabricação De Cachaça, Cerveja, Vinhos E Outras Bebidas",2396.412627844435,962,10746,9784
7,Médio Completo,8418,"Operadores De Equipamentos Na Fabricação De Pães, Massas Alimentícias, Doces, Chocolates E Achocolatados",2362.436839242599,-3897,26208,30105
7,Médio Completo,8421,Cigarreiros E Beneficiadores De Fumo,1555.9748954134939,905,19402,18497
7,Médio Completo,8422,Charuteiros,1495.512762363293,29,191,162
7,Médio Completo,8481,Trabalhadores Artesanais Na Conservação De Alimentos,1739.8141034216044,-417,10984,11401
7,Médio Completo,8482,Trabalhadores Artesanais Na Pasteurização Do Leite E Na Fabricação De Laticínios E Afins,1758.7949538776265,265,5441,5176
7,Médio Completo,8483,"Padeiros, Confeiteiros E Afins",1904.396578294924,827,219133,218306
7,Médio Completo,8484,Trabalhadores Na Degustação E Classificação De Grãos E Afins,1757.9677800185764,2023,20000,17977
7,Médio Completo,8485,Magarefes E Afins,1619.1889806203108,25666,540152,514486
7,Médio Completo,8486,Trabalhadores Artesanais Na Indústria Do Fumo,1419.35903510152,124,1894,1770
7,Médio Completo,8601,Supervisores Da Produção De Utilidades,4404.653881206522,-1440,7787,9227
7,Médio Completo,8611,"Operadores De Instalações De Geração E Distribuição De Energia Elétrica, Hidráulica, Térmica Ou Nuclear",4340.420432908646,553,4908,4355
7,Médio Completo,8612,Operadores De Instalações De Distribuição De Energia Elétrica,3137.082986796387,-387,1429,1816
7,Médio Completo,8621,Operadores De Máquinas A Vapor E Utilidades,3636.424377194879,5697,201179,195482
7,Médio Completo,8622,"Operadores De Instalações De Captação, Tratamento E Distribuição De Água",3273.5880120341685,2876,10784,7908
7,Médio Completo,8623,Operadores De Instalações De Captação E Esgotos,1975.1765790222753,3047,19708,16661
7,Médio Completo,8624,"Operadores De Instalações De Extração, Processamento, Envasamento E Distribuição De Gases",3044.7001252192904,258,2060,1802
7,Médio Completo,8625,Operadores De Instalações De Refrigeração E Ar-Condicionado,2149.74817188823,545,6954,6409
7,Médio Completo,9101,"Supervisores Em Serviços De Reparação E Manutenção De Máquinas E Equipamentos Industriais, Comerciais E Residenciais",4257.301186087493,-276,27312,27588
7,Médio Completo,9102,Supervisores Em Serviços De Reparação E Manutenção Veicular,3518.849556803318,122,7446,7324
7,Médio Completo,9109,"Supervisores De Outros Trabalhadores De Serviços De Reparação, Conservação E Manutenção",2754.45055573906,-19,641,660
7,Médio Completo,9111,"Mecânicos De Manutenção De Bombas, Motores, Compressores E Equipamentos De Transmissão",2284.488062494152,3689,26242,22553
7,Médio Completo,9112,Mecânicos De Manutenção E Instalação De Aparelhos De  Climatização E Refrigeração,1888.88905289092,6670,57188,50518
7,Médio Completo,9113,Mecânicos De Manutenção De Máquinas Industriais,3128.703913295206,35631,318656,283025
7,Médio Completo,9131,Mecânicos De Manutenção De Máquinas Pesadas E Equipamentos Agrícolas,2917.5428546187286,7518,49905,42387
7,Médio Completo,9141,Mecânicos De Manutenção Aeronáutica,3188.378854294036,566,6543,5977
7,Médio Completo,9142,Mecânicos De Manutenção De Motores E Equipamentos Navais,2368.952401827482,275,1289,1014
7,Médio Completo,9143,Mecânicos De Manutenção Metroferroviária,2091.885102191826,560,5540,4980
7,Médio Completo,9144,Mecânicos De Manutenção De Veículos Automotores,4684.377550669692,41246,333895,292649
7,Médio Completo,9151,Técnicos Em Manutenção E Reparação De Instrumentos De Medição E Precisão,3464.776159007701,761,5583,4822
7,Médio Completo,9152,Restauradores De Instrumentos Musicais,1738.5209311982655,11,172,161
7,Médio Completo,9153,Técnicos Em Manutenção E Reparação De Equipamentos Biomédicos,2297.592297203676,1470,5193,3723
7,Médio Completo,9154,Reparadores De Equipamentos Fotográficos,1847.3794518156424,13,96,83
7,Médio Completo,9191,Lubrificadores,2319.6298515616622,1854,28026,26172
7,Médio Completo,9192,"Trabalhadores De Manutenção De Roçadeiras, Motoserras E Similares",2057.8973271214277,592,21598,21006
7,Médio Completo,9193,Mecânicos De Manutenção De Bicicletas E Equipamentos Esportivos E De Ginástica,1627.017388783044,740,11083,10343
7,Médio Completo,9501,"Supervisores De Manutenção Eletroeletrônica Industrial, Comercial E Predial",4371.193603889641,217,17627,17410
7,Médio Completo,9502,Supervisores De Manutenção Eletroeletrônica Veicular,2798.9713214777285,-336,1101,1437
7,Médio Completo,9503,Supervisores De Manutenção Eletromecânica,6394.939689800017,-205,5185,5390
7,Médio Completo,9511,Eletricistas De Manutenção Eletroeletrônica,2728.795302785774,10794,160518,149724
7,Médio Completo,9513,Instaladores E Mantenedores De Sistemas Eletroeletrônicos De Segurança,1663.409991596713,13334,85371,72037
7,Médio Completo,9531,"Eletricistas Eletrônicos De Manutenção Veicular (Aérea, Terrestre E Naval)",3154.3623151345796,1838,32000,30162
7,Médio Completo,9541,"Instaladores E Mantenedores Eletromecânicos De Elevadores, Escadas E Portas Automáticas",2602.2834582108953,2861,27614,24753
7,Médio Completo,9542,Reparadores De Aparelhos Eletrodomésticos,1993.0901814685994,118,4180,4062
7,Médio Completo,9543,Reparadores De Equipamentos De Escritório,1844.0791292271956,18,1737,1719
7,Médio Completo,9911,Conservadores De Vias Permanentes (Trilhos),2161.7308758686204,938,9129,8191
7,Médio Completo,9912,Mantenedores De Equipamentos De Parques De Diversões E Similares,1552.4833047366953,175,1486,1311
7,Médio Completo,9913,Reparadores De Carrocerias De Veículos,1910.4869537395336,2815,40233,37418
7,Médio Completo,9914,Mantenedores de edificações,2823.75,-1,0,1
7,Médio Completo,9921,Trabalhadores Elementares De Serviços De Manutenção Veicular,2014.3146617282978,4983,51454,46471
7,Médio Completo,9922,Trabalhadores Operacionais De Conservação De Vias Permanentes (Exceto Trilhos),1989.965689511138,14982,139999,125017
8,Superior Incompleto,0000,Não especificado,2945.308163300261,1124,1682,558
8,Superior Incompleto,0101,Oficiais Generais Das Forças Armadas,2323.4459164987597,0,135,135
8,Superior Incompleto,0102,Oficiais Das Forças Armadas,2770.0816692666053,-6,8,14
8,Superior Incompleto,0103,Praças Das Forças Armadas,2575.354437934028,-5,1,6
8,Superior Incompleto,0201,Oficiais Superiores Da Polícia Militar,1006.5714285714286,-8,0,8
8,Superior Incompleto,0212,Cabos E Soldados Da Polícia Militar,2103.489990234375,1,3,2
8,Superior Incompleto,0311,Subtenentes E Sargentos Do Corpo De Bombeiros Militar,1647.1300048828125,0,1,1
8,Superior Incompleto,0312,Cabos E Soldados Do Corpo De Bombeiros Militar,2539.4524993896484,1,3,2
8,Superior Incompleto,1111,Legisladores,3543.3887639647,-12,38,50
8,Superior Incompleto,1112,Dirigentes Gerais Da Administração Pública,1838.857965756437,32,279,247
8,Superior Incompleto,1113,Magistrados,1759.75,2,3,1
8,Superior Incompleto,1114,Dirigentes Do Serviço Público,2236.4171652735617,419,770,351
8,Superior Incompleto,1115,Gestores Públicos,4049.6843449464855,281,847,566
8,Superior Incompleto,1130,"Dirigentes De Povos Indígenas, De Quilombolas E Caiçaras",2273.800380859375,-1,12,13
8,Superior Incompleto,1142,Dirigentes E Administradores De Entidades Patronais E Dos Trabalhadores E De Outros Interesses Sócioeconômicos,3780.0277052659253,-8,17,25
8,Superior Incompleto,1143,Dirigentes E Administradores De Entidades Religiosas,3027.4889953613283,-2,9,11
8,Superior Incompleto,1144,Dirigentes E Administradores De Organizações Da Sociedade Civil Sem Fins Lucrativos,5967.13996887207,-2,7,9
8,Superior Incompleto,1210,Diretores Gerais,6887.937422003138,-55,591,646
8,Superior Incompleto,1221,"Diretores De Produção E Operações Em Empresa Agropecuária, Pesqueira , Aqüícola E Florestal",5405.826682350852,7,16,9
8,Superior Incompleto,1222,"Diretores De Produção E Operações Em Empresa Da Indústria Extrativa, Transformação E De Serviços De Utilidade Pública",7012.819411399148,7,31,24
8,Superior Incompleto,1223,Diretores De Operações De Obras Em Empresa De Construção,5483.20122917331,-1,25,26
8,Superior Incompleto,1224,Diretores De Operações Em Empresa Do Comércio,9438.652280273438,-26,62,88
8,Superior Incompleto,1225,"Diretores De Serviços De Turismo, De Alojamento E De Alimentação",5392.043877928457,-26,70,96
8,Superior Incompleto,1226,"Diretores De Operações De Serviços Em Empresa De Armazenamento, De Transporte E De Telecomunicação",6037.694804228673,-22,91,113
8,Superior Incompleto,1227,Diretores De Operações De Serviços Em Instituição De Intermediação Financeira,13558.047399316225,25,75,50
8,Superior Incompleto,1231,Diretores Administrativos E Financeiros,6225.837625835688,-131,1325,1456
8,Superior Incompleto,1232,Diretores De Recursos Humanos E Relações De Trabalho,3899.0287475585938,-23,45,68
8,Superior Incompleto,1233,Diretores De Comercialização E Marketing,6434.269388586618,-105,548,653
8,Superior Incompleto,1234,Diretores De Suprimentos E Afins,6309.9876583764835,-2,42,44
8,Superior Incompleto,1236,Diretores De Tecnologia Da Informação,11467.930335381092,-14,110,124
8,Superior Incompleto,1237,Diretores De Pesquisa E Desenvolvimento,17754.58157113882,-4,24,28
8,Superior Incompleto,1238,Diretores De Manutenção,4547.6354583030525,4,45,41
8,Superior Incompleto,1311,"Diretores E Gerentes De Operações Em Empresa De Serviços Pessoais, Sociais E Culturais",3501.3546347646634,-152,680,832
8,Superior Incompleto,1312,"Gestores E Especialistas De Operações Em Empresas, Secretarias E Unidades De Serviços De Saúde",3304.278443605844,-12,336,348
8,Superior Incompleto,1313,Diretores E Gerentes De Instituição De Serviços Educacionais,3063.5100797383593,-100,366,466
8,Superior Incompleto,1411,"Gerentes De Produção E Operações Em Empresa Agropecuária, Pesqueira, Aqüícola E Florestal",3575.056141929425,-25,530,555
8,Superior Incompleto,1412,"Gerentes De Produção E Operações Em Empresa Da Indústria Extrativa, De Transformação E De Serviços De Utilidade Pública",4889.796842351617,-704,3058,3762
8,Superior Incompleto,1413,Gerentes De Obras Em Empresa De Construção,4248.484007537681,-89,712,801
8,Superior Incompleto,1414,Gerentes De Operações Comerciais E De Assistência Técnica,2694.5702258671627,-3613,14714,18327
8,Superior Incompleto,1415,"Gerentes De Operações De Serviços Em Empresa De Turismo, De Alojamento E Alimentação",2833.063707111524,-1047,4746,5793
8,Superior Incompleto,1416,"Gerentes De Operações De Serviços Em Empresa De Transporte, De Comunicação E De Logística (Armazenagem E Distribuição)",4172.319342514245,-800,2653,3453
8,Superior Incompleto,1417,Gerentes De Operações De Serviços Em Instituição De Intermediação Financeira,5694.847984217498,-801,973,1774
8,Superior Incompleto,1418,Gerentes Operacionais Da Aviação Civil,5122.754531616211,4,27,23
8,Superior Incompleto,1421,"Gerentes Administrativos, Financeiros, De Riscos E Afins",4086.8819872117724,-3379,23895,27274
8,Superior Incompleto,1422,Gerentes De Recursos Humanos E De Relações Do Trabalho,3491.6389345078223,-815,3263,4078
8,Superior Incompleto,1423,"Gerentes De Comercialização, Marketing E Comunicação",58822.600530066265,15450,74391,58941
8,Superior Incompleto,1424,Gerentes De Suprimentos E Afins,3723.5222345248135,-296,1419,1715
8,Superior Incompleto,1425,Gerentes De Tecnologia Da Informação,7165.563277886909,514,4480,3966
8,Superior Incompleto,1426,Gerentes De Pesquisa E Desenvolvimento E Afins,5416.657984287132,-38,754,792
8,Superior Incompleto,1427,Gerentes De Manutenção E Afins,4196.1692094763985,-101,1381,1482
8,Superior Incompleto,2011,Profissionais Da Biotecnologia,2674.3502196518743,29,137,108
8,Superior Incompleto,2012,Profissionais Da Metrologia,3699.830061395015,-11,58,69
8,Superior Incompleto,2021,"Engenheiros De Controle E Automação, Engenheiros Mecatrônicos E Afins",3830.069740355864,154,423,269
8,Superior Incompleto,2030,Pesquisadores Das Ciências Biológicas,2862.102555766987,17,73,56
8,Superior Incompleto,2031,Pesquisadores Das Ciências Naturais E Exatas,3742.577983202792,375,653,278
8,Superior Incompleto,2032,Pesquisadores De Engenharia E Tecnologia,4395.842700312131,624,1136,512
8,Superior Incompleto,2033,Pesquisadores Das Ciências Da Saúde,4109.480315762966,102,213,111
8,Superior Incompleto,2034,Pesquisadores Das Ciências Da Agricultura,2406.361607303659,69,180,111
8,Superior Incompleto,2035,Pesquisadores Das Ciências Sociais E Humanas,2660.1248950023687,29,118,89
8,Superior Incompleto,2041,Peritos Criminais E Judiciais,1601.3333333333333,0,3,3
8,Superior Incompleto,2111,Profissionais Da Matemática,4889.920987234328,325,635,310
8,Superior Incompleto,2112,Profissionais De Estatística E Afins,5011.561808334683,410,669,259
8,Superior Incompleto,2122,Engenheiros Em Computação,7984.917622302135,2599,5039,2440
8,Superior Incompleto,2123,Administradores De Tecnologia Da Informação,5000.378337056957,3019,7593,4574
8,Superior Incompleto,2124,Analistas De Tecnologia Da Informação,4885.882744943833,42823,116692,73869
8,Superior Incompleto,2131,Físicos,14248.835088094074,2,13,11
8,Superior Incompleto,2132,Químicos,3329.470681409311,71,267,196
8,Superior Incompleto,2133,Profissionais Das Ciências Atmosféricas E Espaciais E De Astronomia,3347.594002278646,4,10,6
8,Superior Incompleto,2134,"Geólogos, Oceanógrafos, Geofísicos E Afins",3939.6281927798495,35,124,89
8,Superior Incompleto,2140,Engenheiros Ambientais E Afins,3739.835697404931,127,305,178
8,Superior Incompleto,2141,Arquitetos E Urbanistas,3078.1820221022067,163,602,439
8,Superior Incompleto,2142,Engenheiros Civis E Afins,4535.129351262659,303,2519,2216
8,Superior Incompleto,2143,"Engenheiros Eletricistas, Eletrônicos E Afins",4690.201570095646,403,1145,742
8,Superior Incompleto,2144,Engenheiros Mecânicos E Afins,5769.4958675931575,408,839,431
8,Superior Incompleto,2145,Engenheiros Químicos E Afins,7209.764835873591,102,165,63
8,Superior Incompleto,2146,"Engenheiros Metalurgistas, De Materiais E Afins",4960.961671620906,48,95,47
8,Superior Incompleto,2147,Engenheiros De Minas E Afins,6184.23921399479,54,107,53
8,Superior Incompleto,2148,Engenheiros Agrimensores E Engenheiros Cartógrafos,3106.425341078814,18,30,12
8,Superior Incompleto,2149,"Engenheiros De Produção, Qualidade, Segurança E Afins",5118.705412863494,599,1707,1108
8,Superior Incompleto,2151,Oficiais De Convés E Afins,4131.308869507336,49,238,189
8,Superior Incompleto,2152,Oficiais De Máquinas Da Marinha Mercante,5510.714603258848,20,77,57
8,Superior Incompleto,2153,Profissionais Da Pilotagem Aeronáutica,4337.727710478442,-116,472,588
8,Superior Incompleto,2211,Biólogos E Afins,2518.422306373026,-3,139,142
8,Superior Incompleto,2212,Biomédicos,2331.7778969166075,-29,469,498
8,Superior Incompleto,2221,Engenheiros Agrossilvipecuários,3493.64245758057,341,674,333
8,Superior Incompleto,2222,Engenheiros De Alimentos E Afins,2749.22280324712,21,62,41
8,Superior Incompleto,2232,Cirurgiões-Dentistas,2781.703192783249,-1,70,71
8,Superior Incompleto,2233,Veterinários E Zootecnistas,3025.929758657556,71,291,220
8,Superior Incompleto,2234,Farmacêuticos,3495.807319724145,434,2399,1965
8,Superior Incompleto,2235,Enfermeiros E Afins,3554.7691529902413,356,2817,2461
8,Superior Incompleto,2236,Fisioterapeutas,2419.3896984760427,55,526,471
8,Superior Incompleto,2237,Nutricionistas,2016.6116300086533,204,1020,816
8,Superior Incompleto,2238,Fonoaudiólogos,2462.158834498682,27,183,156
8,Superior Incompleto,2239,"Terapeutas Ocupacionais, Ortoptistas E Psicomotricistas",1894.2616715639767,133,280,147
8,Superior Incompleto,2241,Profissionais Da Educação Física,3949.0051175333306,761,5197,4436
8,Superior Incompleto,2251,Médicos Clínicos,5777.618531152354,-11,285,296
8,Superior Incompleto,2252,Médicos Em Especialidades Cirúrgicas,3982.3354668487577,-1,34,35
8,Superior Incompleto,2253,Médicos Em Medicina Diagnóstica E Terapêutica,2970.6868048252204,7,21,14
8,Superior Incompleto,2263,"Profissionais Das Terapias Criativas,Equoterápicas E Naturológicas",2118.3950352853344,7,24,17
8,Superior Incompleto,2311,Professores De Nível Superior Na Educação Infantil,2409.2786920742765,476,5774,5298
8,Superior Incompleto,2312,Professores De Nível Superior Do Ensino Fundamental (Primeira A Quarta Séries),4490.618168198436,204,7974,7770
8,Superior Incompleto,2313,Professores De Nível Superior No Ensino Fundamental De Quinta A Oitava Série,2813.763132551852,410,3745,3335
8,Superior Incompleto,2321,Professores Do Ensino Médio,2820.196015604502,111,3229,3118
8,Superior Incompleto,2331,Professores Do Ensino Profissional,3859.91838206085,-8,243,251
8,Superior Incompleto,2332,Instrutores De Ensino Profissional,3767.995203701003,-705,3985,4690
8,Superior Incompleto,2341,"Professores De Matemática, Estatística E Informática Do Ensino Superior",1082.0749822486043,6,55,49
8,Superior Incompleto,2342,"Professores De Ciências Físicas, Químicas E Afins Do Ensino Superior",2357.5557225772313,4,23,19
8,Superior Incompleto,2343,"Professores De Arquitetura E Urbanismo, Engenharia, Geofísica E Geologia Do Ensino Superior",1860.0198204300623,-24,9,33
8,Superior Incompleto,2344,Professores De Ciências Biológicas E Da Saúde Do Ensino Superior,3040.897881167791,9,278,269
8,Superior Incompleto,2345,Professores Na Área De Formação Pedagógica Do Ensino Superior,2101.549984393757,-185,417,602
8,Superior Incompleto,2346,Professores Nas Áreas De Língua E Literatura Do Ensino Superior,2306.9592977146203,777,4923,4146
8,Superior Incompleto,2347,Professores De Ciências Humanas Do Ensino Superior,2023.954892928025,-25,23,48
8,Superior Incompleto,2348,"Professores De Ciências Econômicas, Administrativas E Contábeis Do Ensino Superior",2306.7128619570963,107,237,130
8,Superior Incompleto,2349,Professores De Artes Do Ensino Superior,2536.7032938536863,29,225,196
8,Superior Incompleto,2392,Professores De Educação Especial,5313.3119365629045,133,608,475
8,Superior Incompleto,2394,"Programadores, Avaliadores E Orientadores De Ensino",2618.980062347717,2791,11653,8862
8,Superior Incompleto,2410,Advogados,5200.9707889891115,1846,6204,4358
8,Superior Incompleto,2412,Procuradores E Advogados Públicos,1536.3419708251954,-2,7,9
8,Superior Incompleto,2413,Tabeliães E Registradores,2114.2981792189053,-101,267,368
8,Superior Incompleto,2422,Membros Do Ministério Público,3413.5333658854165,1,2,1
8,Superior Incompleto,2424,Defensores Públicos E Procuradores Da Assistência Judiciária,4096.207355700041,11,34,23
8,Superior Incompleto,2429,Profissionais Da Inteligência,3464.9336362896543,20,50,30
8,Superior Incompleto,2511,Profissionais Em Pesquisa E Análise Antropológica Sociológica,2675.991367255317,4,22,18
8,Superior Incompleto,2512,Economistas,3868.1481201436113,1247,5302,4055
8,Superior Incompleto,2513,Profissionais Em Pesquisa E Análise Geográfica,2770.903455699574,21,38,17
8,Superior Incompleto,2514,Filósofos,2581.4866536458335,1,2,1
8,Superior Incompleto,2515,Psicólogos E Psicanalistas,2962.119284045145,219,829,610
8,Superior Incompleto,2516,Assistentes Sociais E Economistas Domésticos,2337.508646811985,43,481,438
8,Superior Incompleto,2521,Administradores,3382.2875231794474,8323,27222,18899
8,Superior Incompleto,2522,Contadores E Afins,3042.2249476444044,1306,16019,14713
8,Superior Incompleto,2523,Secretárias(Os) Executivas(Os) E Afins,1970.9455395699395,429,13669,13240
8,Superior Incompleto,2524,Profissionais De Recursos Humanos,2881.117542666673,4629,20061,15432
8,Superior Incompleto,2525,Profissionais De Administração Ecônomico-Financeira,3847.3185539746305,5280,16798,11518
8,Superior Incompleto,2526,Profissionais Da Administração Dos Serviços De Segurança,4341.338188195762,37,175,138
8,Superior Incompleto,2527,"Profissionais De Planejamento, Programação E Controles Logisticos",3321.1185412867367,1869,5336,3467
8,Superior Incompleto,2531,Profissionais De Publicidade,3630.24000310865,3625,14695,11070
8,Superior Incompleto,2532,Profissionais De Comercializacão E Consultoria De Serviços Bancários,5140.662203369583,-881,13353,14234
8,Superior Incompleto,2533,"Corretores De Valores, Ativos Financeiros, Mercadorias E Derivativos",3681.3376973966274,224,932,708
8,Superior Incompleto,2534,Profissionais De Mídias Digitais E Afins,2284.6824116131684,1268,3160,1892
8,Superior Incompleto,2541,Auditores Fiscais E Técnicos Da Receita Federal,2734.829275948661,4,12,8
8,Superior Incompleto,2542,Auditores Fiscais Da Previdência Social,2301.085001627604,2,4,2
8,Superior Incompleto,2543,Auditores Fiscais Do Trabalho,1871.1052093050375,-23,61,84
8,Superior Incompleto,2544,Fiscais De Tributos Estaduais E Municipais,2789.167903634204,34,251,217
8,Superior Incompleto,2545,Profissionais Da Fiscalização De Atividades Urbanas,2349.836416391226,18,48,30
8,Superior Incompleto,2611,Profissionais Do Jornalismo,2954.5677469905822,681,3486,2805
8,Superior Incompleto,2612,Profissionais Da Informação,3066.4268705374357,1622,5620,3998
8,Superior Incompleto,2613,Arquivistas E Museólogos,1940.3880621528997,-5,559,564
8,Superior Incompleto,2614,"Filólogos,Tradutores ,Intérpretes E Afins",3143.774936438787,222,981,759
8,Superior Incompleto,2615,Profissionais Da Escrita,3748.385303120371,84,517,433
8,Superior Incompleto,2616,Editores,3356.876714906886,99,594,495
8,Superior Incompleto,2617,"Locutores, Comentaristas E Repórteres De Mídias Audiovisuais",3101.5681848388413,-13,1110,1123
8,Superior Incompleto,2618,Fotógrafos Profissionais,2672.3528298643814,-27,588,615
8,Superior Incompleto,2619,Assistentes De Direção (Tv) E Continuístas,1870.2933422642895,14,31,17
8,Superior Incompleto,2621,Produtores Artísticos E Culturais,2868.926323697206,331,1351,1020
8,Superior Incompleto,2622,Diretores De Espetáculos E Afins,6050.4865080733825,-49,83,132
8,Superior Incompleto,2623,Cenógrafos,2515.949418042161,-27,507,534
8,Superior Incompleto,2624,"Artistas Visuais,Desenhistas Industriais E Conservadores-Restauradores De Bens Culturais",2997.4092035830845,3325,12773,9448
8,Superior Incompleto,2625,Atores,24762.188770398418,-49,67,116
8,Superior Incompleto,2626,"Músicos Compositores, Arranjadores, Regentes E Musicólogos",3452.113264542999,-15,133,148
8,Superior Incompleto,2627,Músicos Intérpretes,3357.270803017927,3,243,240
8,Superior Incompleto,2628,Artistas Da Dança (Exceto Dança Tradicional E Popular),2661.6175244688675,-8,708,716
8,Superior Incompleto,2629,Designer De Interiores De Nível Superior,2703.2535521081613,5,91,86
8,Superior Incompleto,2631,"Ministros De Culto, Missionários, Teólogos E Profissionais Assemelhados",2176.2297768107733,-11,203,214
8,Superior Incompleto,2711,Chefes De Cozinha E Afins,2439.179953812827,-60,1282,1342
8,Superior Incompleto,3001,Técnicos Em Mecatrônica,4198.490193235255,276,1183,907
8,Superior Incompleto,3003,Técnicos Em Eletromecânica,2861.8422594979425,145,1304,1159
8,Superior Incompleto,3011,Técnicos De Laboratório Industrial,2520.733568541533,843,4400,3557
8,Superior Incompleto,3012,Técnicos De Apoio À Bioengenharia,2501.1117887951077,8,46,38
8,Superior Incompleto,3111,Técnicos Químicos,2833.8685948174993,596,3330,2734
8,Superior Incompleto,3112,"Técnicos De Produção De Indústrias Químicas, Petroquímicas, Refino De Petróleo, Gás E Afins",3455.37053327663,-3,45,48
8,Superior Incompleto,3113,"Técnicos Em Materiais, Produtos Cerâmicos E Vidros",7927.181987847222,-8,41,49
8,Superior Incompleto,3114,Técnicos Em Fabricação De Produtos Plásticos E De Borracha,3392.453974463396,13,282,269
8,Superior Incompleto,3115,"Técnicos Em Controle Ambiental, Utilidades E Tratamento De Efluentes",2798.232949979223,395,1373,978
8,Superior Incompleto,3116,Técnicos Têxteis,3345.5042244167576,4,103,99
8,Superior Incompleto,3117,Coloristas,2472.14467690608,-21,433,454
8,Superior Incompleto,3121,Técnicos Em Construção Civil (Edificações),2840.148556000441,6878,21880,15002
8,Superior Incompleto,3122,Técnicos Em Construção Civil (Obras De Infraestrutura),2687.092640064013,222,1144,922
8,Superior Incompleto,3123,Técnicos Em Geomática,3256.4239633323887,181,1571,1390
8,Superior Incompleto,3131,Técnicos Em Eletricidade E Eletrotécnica,3409.8327932729353,431,7495,7064
8,Superior Incompleto,3132,Técnicos Em Eletrônica,2567.0694577217882,1010,21403,20393
8,Superior Incompleto,3133,Técnicos Em Telecomunicações,2226.261390584131,53,4648,4595
8,Superior Incompleto,3134,Técnicos Em Calibração E Instrumentação,4035.7665727499593,39,851,812
8,Superior Incompleto,3135,Técnicos Em Fotônica,1796.397076278083,-6,351,357
8,Superior Incompleto,3141,"Técnicos Mecânicos Na Fabricação E Montagem De Máquinas, Sistemas E Instrumentos",3111.4741722478343,544,4423,3879
8,Superior Incompleto,3142,Técnicos Mecânicos (Ferramentas),3942.2413445249176,124,601,477
8,Superior Incompleto,3143,Técnicos Em Mecânica Veicular,3590.2043018119275,276,948,672
8,Superior Incompleto,3144,"Técnicos Mecânicos Na Manutenção De Máquinas, Sistemas E Instrumentos",3256.0419785726535,-77,2624,2701
8,Superior Incompleto,3146,Técnicos Em Metalurgia (Estruturas Metálicas),4027.902449957892,-35,297,332
8,Superior Incompleto,3147,Técnicos Em Siderurgia,5920.04460496076,12,88,76
8,Superior Incompleto,3148,Especialistas Em Inspeções Industriais,5404.655335134282,82,227,145
8,Superior Incompleto,3161,Técnicos Em Geologia,2311.533054351199,59,163,104
8,Superior Incompleto,3163,Técnicos Em Mineração,3680.65895441357,235,505,270
8,Superior Incompleto,3171,Técnicos De Desenvolvimento De Sistemas E Aplicações,3793.9792030610142,18424,52468,34044
8,Superior Incompleto,3172,Técnicos De Suporte E Monitoração Ao Usuário De Tecnologia Da Informação.,2162.1983512953084,9922,39426,29504
8,Superior Incompleto,3180,"Desenhistas Técnicos, Em Geral",2528.339247686215,339,2918,2579
8,Superior Incompleto,3181,Desenhistas Técnicos Da Construção Civil E Arquitetura,2847.5270534219717,279,1723,1444
8,Superior Incompleto,3182,Desenhistas Técnicos Da Mecânica,3401.365436174235,229,844,615
8,Superior Incompleto,3183,"Desenhistas Técnicos Em Eletricidade, Eletrônica, Eletromecânica, Calefação, Ventilação E Refrigeração",2526.3428850396826,17,168,151
8,Superior Incompleto,3184,Desenhistas Técnicos De Produtos E Serviços Diversos,2438.333368039164,45,1861,1816
8,Superior Incompleto,3185,Desenhistas Projetistas De Construção Civil E Arquitetura,2717.505605552483,2014,7332,5318
8,Superior Incompleto,3186,Desenhistas Projetistas Da Mecânica,4184.1230436269925,970,4401,3431
8,Superior Incompleto,3187,Desenhistas Projetistas Da Eletrônica,2881.7269551968993,393,1735,1342
8,Superior Incompleto,3188,Desenhistas Projetistas E Modelistas De Produtos E Serviços Diversos,2795.927329848377,281,3215,2934
8,Superior Incompleto,3191,Técnicos Do Vestuário,3035.52601284123,-2,115,117
8,Superior Incompleto,3192,Técnicos Do Mobiliário E Afins,2277.7780295924135,0,38,38
8,Superior Incompleto,3201,Técnicos Em Biologia,2052.2875535284825,32,83,51
8,Superior Incompleto,3211,Técnicos Agrícolas,2615.4563779092978,775,3623,2848
8,Superior Incompleto,3212,Técnicos Florestais,2388.2822812403165,121,489,368
8,Superior Incompleto,3213,Técnicos Em Aqüicultura,1801.446765345386,7,29,22
8,Superior Incompleto,3221,Tecnólogos E Técnicos Em Terapias Complementares E Estéticas,1634.2918027426047,302,3851,3549
8,Superior Incompleto,3222,Técnicos E Auxiliares De Enfermagem,2075.935978972248,444,31437,30993
8,Superior Incompleto,3223,Técnicos Em Óptica E Optometria,1804.6922281690213,-14,186,200
8,Superior Incompleto,3224,Técnicos De Odontologia,1673.5811527562,706,7486,6780
8,Superior Incompleto,3225,Técnicos Em Próteses Ortopédicas,7673.297546985103,0,51,51
8,Superior Incompleto,3226,Técnicos De Imobilizações Ortopédicas,1773.721916450249,0,91,91
8,Superior Incompleto,3231,Técnicos Em Pecuária,2763.819758180712,16,69,53
8,Superior Incompleto,3241,Tecnólogos E Técnicos Em Métodos De Diagnósticos E Terapêutica,1946.6977111078572,-66,1200,1266
8,Superior Incompleto,3242,Técnicos De Laboratórios De Saúde E Bancos De Sangue,2009.1993197215756,531,3509,2978
8,Superior Incompleto,3250,"Enólogos, Perfumistas E Aromistas",3509.479222931062,19,301,282
8,Superior Incompleto,3251,Técnico Em Farmácia E Em Manipulação Farmacêutica,2006.5668378255632,448,2894,2446
8,Superior Incompleto,3252,"Técnicos Em Produção, Conservação  E De Qualidade De Alimentos",2158.3475588143065,1,1180,1179
8,Superior Incompleto,3253,Técnicos De Apoio À Biotecnologia,2014.8728525435397,27,74,47
8,Superior Incompleto,3281,Técnicos Em Necrópsia E Taxidermistas,2696.1004629952567,5,19,14
8,Superior Incompleto,3311,Professores De Nível Médio Na Educação Infantil,1818.3707660182633,14085,55842,41757
8,Superior Incompleto,3312,Professores De Nível Médio No Ensino Fundamental,2976.017213030594,195,5304,5109
8,Superior Incompleto,3313,Professores De Nível Médio No Ensino Profissionalizante,3573.9264211684485,103,779,676
8,Superior Incompleto,3321,Professores Leigos No Ensino Fundamental,1746.4887877476751,517,1997,1480
8,Superior Incompleto,3322,Professores Práticos No Ensino Profissionalizante,3100.422779073816,-26,366,392
8,Superior Incompleto,3331,Instrutores E Professores De Cursos Livres,11100.700969627853,-398,14987,15385
8,Superior Incompleto,3341,Inspetores De Alunos E Afins,1696.6808512649452,4733,16178,11445
8,Superior Incompleto,3411,"Pilotos De Aviação Comercial, Mecânicos De Vôo E Afins",4754.369080559565,39,263,224
8,Superior Incompleto,3412,"Técnicos Marítimos, Fluviários E Pescadores De Convés",2973.562996353532,-14,88,102
8,Superior Incompleto,3413,Técnicos Marítimos E Fluviários De Máquinas,2923.745131167104,11,76,65
8,Superior Incompleto,3421,Especialistas Em Logística De Transportes,2621.3736169411122,2450,14999,12549
8,Superior Incompleto,3422,Despachantes Aduaneiros,2650.834803691941,165,558,393
8,Superior Incompleto,3423,Técnicos Em Transportes Rodoviários,2827.0040953115495,-498,2663,3161
8,Superior Incompleto,3424,Técnicos Em Transportes Metroferroviários,2586.6441739978573,-86,317,403
8,Superior Incompleto,3425,Técnicos Em Transportes Aéreos,3770.832431925015,-438,2659,3097
8,Superior Incompleto,3426,Técnicos Em Transportes Por Vias Navegáveis E Operações Portuárias,3764.3310943467077,-15,228,243
8,Superior Incompleto,3511,Técnicos Em Contabilidade,3069.386265944076,-204,1969,2173
8,Superior Incompleto,3513,Técnicos Em Administração,2799.652914478338,1141,5206,4065
8,Superior Incompleto,3514,Serventuários Da Justiça E Afins,2158.8373088805597,5038,20285,15247
8,Superior Incompleto,3515,"Técnicos Em Secretariado, Taquígrafos E Estenotipistas",1715.8507640765508,0,5724,5724
8,Superior Incompleto,3516,Técnicos Em Segurança Do Trabalho,3142.712051142107,522,14690,14168
8,Superior Incompleto,3517,Técnicos De Seguros E Afins,2714.917346354509,868,8491,7623
8,Superior Incompleto,3518,Agentes De Investigação E Identificação,2346.694482421875,-1,7,8
8,Superior Incompleto,3519,Técnicos Da Inteligência,2842.121673951113,20,64,44
8,Superior Incompleto,3522,Agentes Da Saúde E Do Meio Ambiente,2513.8852082706653,492,1835,1343
8,Superior Incompleto,3523,Agentes  Fiscais Metrológicos E De Qualidade,2912.9900898145424,46,905,859
8,Superior Incompleto,3524,Profissionais De Direitos Autorais E De Avaliacão De Produtos Dos Meios De Comunicação,2589.522360151242,30,91,61
8,Superior Incompleto,3532,Técnicos Em Operações E Serviços Bancários,3353.5193892110697,-145,1295,1440
8,Superior Incompleto,3541,Especialistas Em Promoção De Produtos E Vendas,2642.7530350865013,10772,111508,100736
8,Superior Incompleto,3542,Compradores,3360.6322355585303,736,11393,10657
8,Superior Incompleto,3543,Analistas De Comércio Exterior,3423.7425285696477,757,3316,2559
8,Superior Incompleto,3544,Leiloeiros E Avaliadores,2091.1807550705057,38,608,570
8,Superior Incompleto,3545,Corretores De Seguros,1552.0639609060947,-35,380,415
8,Superior Incompleto,3546,Corretores De Imóveis E De Grãos,3396.273586437874,0,779,779
8,Superior Incompleto,3547,Representantes Comerciais Autônomos,2662.872078848576,-37,672,709
8,Superior Incompleto,3548,Técnicos Em Serviços De Turismo E Organização De Eventos,2260.488472113096,-219,6086,6305
8,Superior Incompleto,3711,Técnicos Em Biblioteconomia,2065.4455059649617,10,1033,1023
8,Superior Incompleto,3712,Técnicos Em Museologia E Afins,1708.2920847925648,-5,12,17
8,Superior Incompleto,3713,Técnicos Em Artes Gráficas,2256.8200802401716,-28,218,246
8,Superior Incompleto,3714,Recreadores,1739.4543323723944,1408,10820,9412
8,Superior Incompleto,3721,Captadores De Imagens Em Movimento,4271.742194105539,-79,527,606
8,Superior Incompleto,3722,Operadores De Rede De Teleprocessamento E Afins,3066.6710455027574,661,3225,2564
8,Superior Incompleto,3731,Técnicos De Operação De Registros Sonoro/Audiovisuais,2493.0189812601866,200,1796,1596
8,Superior Incompleto,3732,Supervisores Operacionais E Técnicos Em Mídias Audiovisuais,3509.4520970296594,-256,435,691
8,Superior Incompleto,3741,Técnicos Em Áudio,1909.3159265143695,-55,799,854
8,Superior Incompleto,3742,Técnicos Em Cenografia,1991.247412870701,-14,310,324
8,Superior Incompleto,3743,Técnicos Em Operação De Aparelhos De Projeção,2120.1099775041853,-14,40,54
8,Superior Incompleto,3744,"Técnicos Em Montagem, Edição E Finalização De Mídia Audiovisual",2761.3691551646493,352,2082,1730
8,Superior Incompleto,3751,"Designers De Interiores, De Vitrines E Visual Merchandiser E Afins (Nível Médio)",2029.962019553941,-217,1617,1834
8,Superior Incompleto,3761,Dançarinos Tradicionais E Populares,2442.3193242977827,-5,23,28
8,Superior Incompleto,3762,Artistas De Circo (Circenses),1928.1285628876128,1,35,34
8,Superior Incompleto,3763,"Apresentadores De Eventos, Programas E Espetáculos",3406.746915244525,-26,166,192
8,Superior Incompleto,3764,Modelos,1628.863049547798,-21,61,82
8,Superior Incompleto,3771,Atletas Profissionais,3468.916863810079,44,955,911
8,Superior Incompleto,3772,Árbitros Desportivos,2056.5921557845404,6,55,49
8,Superior Incompleto,3911,"Planejadores, Programadores E Controladores De Produção E Manutenção",4265.576037854535,3592,21977,18385
8,Superior Incompleto,3912,Técnicos De Controle Da Produção,2468.349292127868,4444,27097,22653
8,Superior Incompleto,3951,Técnicos De Apoio Em Pesquisa E Desenvolvimento,2735.0993815842044,1053,3959,2906
8,Superior Incompleto,4101,Supervisores Administrativos,3262.4779121346264,-6721,22101,28822
8,Superior Incompleto,4102,"Supervisores De Serviços Financeiros, De Câmbio E De Controle",3416.5434728344926,-1440,7325,8765
8,Superior Incompleto,4110,"Agentes, Assistentes E Auxiliares Administrativos",2187.6876654043353,57903,749393,691490
8,Superior Incompleto,4121,Operadores De Equipamentos De Entrada E Transmissão De Dados,1901.4962223476437,-335,3623,3958
8,Superior Incompleto,4122,Contínuos,1405.0218866272048,-1526,7063,8589
8,Superior Incompleto,4131,Auxiliares De Contabilidade,2262.8951339138926,19123,102898,83775
8,Superior Incompleto,4132,Escriturários De Serviços Bancários,2175.258463722003,16212,37307,21095
8,Superior Incompleto,4141,Almoxarifes E Armazenistas,1783.557723426362,5105,93867,88762
8,Superior Incompleto,4142,Apontadores E Conferentes,2161.3569441660743,-771,11266,12037
8,Superior Incompleto,4151,"Auxiliares De Serviços De Documentação, Informação E Pesquisa",1976.3339804534367,184,3350,3166
8,Superior Incompleto,4152,"Trabalhadores Nos Serviços De Classificação E Entregas De Correspondências, Encomendas E Publicações",1692.524136169103,-365,566,931
8,Superior Incompleto,4153,Trabalhadores Em Registros E Informações Em Saúde,2554.558308919271,0,3,3
8,Superior Incompleto,4201,Supervisores De Atendimento Ao Público E De Pesquisa,2550.7097435178025,-3560,9506,13066
8,Superior Incompleto,4211,Caixas E Bilheteiros (Exceto Caixa De Banco),1771.2848838672858,-9130,87750,96880
8,Superior Incompleto,4212,Coletadores De Apostas E De Jogos,1469.1763507480493,-358,1553,1911
8,Superior Incompleto,4213,Cobradores E Afins,1627.024863236785,-1414,18236,19650
8,Superior Incompleto,4221,Recepcionistas,1864.862933858206,3009,138626,135617
8,Superior Incompleto,4222,Operadores De Telefonia,3807.5086157164956,-1260,7755,9015
8,Superior Incompleto,4223,Operadores De Telemarketing E Afins,1514.8282394229727,-9097,151766,160863
8,Superior Incompleto,4231,Despachantes Documentalistas E Afins,1681.585825660881,23,567,544
8,Superior Incompleto,4241,Entrevistadores E Recenseadores,1674.5980835143312,63,2068,2005
8,Superior Incompleto,4242,Aplicadores De Provas E Afins,1544.1810801914762,15,44,29
8,Superior Incompleto,5101,"Supervisores Dos Serviços De Transporte, Turismo, Hotelaria E Administração De Edifícios",2559.48421500816,-464,2300,2764
8,Superior Incompleto,5102,Supervisores De Lavanderia,2710.936494556511,-21,148,169
8,Superior Incompleto,5103,"Supervisores Dos Serviços De Proteção, Segurança E Outros",3125.998069608413,-217,954,1171
8,Superior Incompleto,5111,Trabalhadores De Segurança E Atendimento Aos Usuários Nos Transportes,1816.9223162017277,-526,335,861
8,Superior Incompleto,5112,Fiscais E Cobradores Dos Transportes Coletivos,2252.802110609573,-404,2926,3330
8,Superior Incompleto,5114,Guias De Turismo,1801.8362737917432,-16,94,110
8,Superior Incompleto,5115,Condutores De Turismo,1805.0598910717254,0,24,24
8,Superior Incompleto,5121,Trabalhadores Dos Serviços Domésticos Em Geral,1414.0096332899661,67,392,325
8,Superior Incompleto,5131,Mordomos E Governantas,2045.9900873730721,-57,458,515
8,Superior Incompleto,5132,Cozinheiros,1698.9976710525261,-385,11751,12136
8,Superior Incompleto,5133,"Camareiros, Roupeiros E Afins",1889.7178529720445,-102,2161,2263
8,Superior Incompleto,5134,"Trabalhadores No Atendimento Em Estabelecimentos De Serviços De Alimentação, Bebidas E Hotelaria",1988.7374236093065,-2994,45417,48411
8,Superior Incompleto,5135,Trabalhadores Auxiliares Nos Serviços De Alimentação,1723.4876799352235,951,17644,16693
8,Superior Incompleto,5136,"Churrasqueiros, Pizzaiolos E Sushimen",1661.0250133293466,74,1548,1474
8,Superior Incompleto,5141,Trabalhadores Nos Serviços De Administração De Edifícios,2075.86324124112,40,5782,5742
8,Superior Incompleto,5142,"Trabalhadores Nos Serviços De Coleta De Resíduos, De Limpeza E Conservação De Áreas Públicas",1372.9050481163777,-317,4896,5213
8,Superior Incompleto,5143,Trabalhadores Nos  Serviços De Manutenção De Edificações,2448.3185499441665,741,34606,33865
8,Superior Incompleto,5151,Trabalhadores Em Serviços De Promoção E Apoio À Saúde,2177.1053136516693,587,3465,2878
8,Superior Incompleto,5152,Auxiliares De Laboratório Da Saúde,1820.3290394463613,3181,14341,11160
8,Superior Incompleto,5153,"Trabalhadores De Atenção, Defesa E Proteção A Pessoas Em Situação De Risco E Adolescentes Em Conflito Com A Lei",2169.0582725963905,1624,8713,7089
8,Superior Incompleto,5161,Trabalhadores Nos Serviços De Embelezamento E Higiene,1822.6736402847623,-320,796,1116
8,Superior Incompleto,5162,"Cuidadores De Crianças, Jovens, Adultos E Idosos",1868.1022036952409,1550,7653,6103
8,Superior Incompleto,5163,"Tintureiros, Lavadeiros E Afins, A Máquina",1797.951755351085,-54,1757,1811
8,Superior Incompleto,5164,"Lavadores E Passadores De Roupa, A Mão",1522.4363458369116,2,91,89
8,Superior Incompleto,5165,Trabalhadores Dos Serviços Funerários,1821.666171300979,112,728,616
8,Superior Incompleto,5166,Trabalhadores Auxiliares Dos Serviços Funerários,1726.5612283109854,9,47,38
8,Superior Incompleto,5167,Astrólogos E Numerólogos,4519,0,1,1
8,Superior Incompleto,5168,Esotéricos E Paranormais,2635,-1,0,1
8,Superior Incompleto,5169,Trabalhadores Nos Serviços De Arte Corporal,1650.7505764431423,3,5,2
8,Superior Incompleto,5171,"Bombeiros, Salva-Vidas E Afins",2267.934427405954,149,2055,1906
8,Superior Incompleto,5172,"Policiais, Guardas-Civis Municipais E Agentes De Trânsito",2279.8286847494037,-25,354,379
8,Superior Incompleto,5173,Vigilantes E Guardas De Segurança,2214.7080214131784,-776,12478,13254
8,Superior Incompleto,5174,"Porteiros, Vigias E Afins",1797.5139960486983,-435,27086,27521
8,Superior Incompleto,5191,Motociclistas E Ciclistas De Entregas Rápidas,1320.3572708745114,-47,4916,4963
8,Superior Incompleto,5192,Trabalhadores Da Coleta E Seleção De Material Reciclável,1505.6577826370115,-11,272,283
8,Superior Incompleto,5193,"Trabalhadores De Serviços Veterinários, De Higiene E Estética De Animais Domésticos",1515.8409338442734,868,5559,4691
8,Superior Incompleto,5198,Profissionais Do Sexo,1040,-1,0,1
8,Superior Incompleto,5199,Outros Trabalhadores Dos Serviços,2200.8581662278257,173,5326,5153
8,Superior Incompleto,5201,Supervisores De Vendas E De Prestação De Serviços,2864.01170682031,-5246,16409,21655
8,Superior Incompleto,5211,Operadores Do Comércio Em Lojas E Mercados,1829.1469576459433,-20758,411277,432035
8,Superior Incompleto,5231,Instaladores De Produtos E Acessórios,1616.1451900604438,-13,671,684
8,Superior Incompleto,5241,Vendedores Em Domicílio,1420.1415552577284,-693,10677,11370
8,Superior Incompleto,5242,"Vendedores Em Bancas, Quiosques E Barracas",1325.497914405969,-38,367,405
8,Superior Incompleto,5243,Vendedores Ambulantes,642.3266037411504,-43,364,407
8,Superior Incompleto,6110,Produtores Agropecuários Em Geral,1507.6894756116365,2,20,18
8,Superior Incompleto,6120,Produtores Agrícolas Polivalentes,1578.8444439923321,2,28,26
8,Superior Incompleto,6121,Produtores Agrícolas Na Cultura De Gramíneas,1603.241007486979,4,8,4
8,Superior Incompleto,6123,Produtores Agrícolas Na Olericultura,1483.278443145752,-3,9,12
8,Superior Incompleto,6124,Produtores Agrícolas No Cultivo De Flores E Plantas Ornamentais,1535.5539993286134,-6,4,10
8,Superior Incompleto,6125,Produtores Agrícolas Na Fruticultura,1707.433748881022,-4,9,13
8,Superior Incompleto,6128,Produtores De Especiarias E De Plantas Aromáticas E Medicinais,1225.139990234375,1,3,2
8,Superior Incompleto,6130,Produtores Em Pecuária Polivalente,1410.0154852098035,3,21,18
8,Superior Incompleto,6131,Produtores Em Pecuária De Animais De Grande Porte,1641.1269376654375,3,16,13
8,Superior Incompleto,6132,Produtores Em Pecuária De Animais De Médio Porte,1779.0560028076172,-1,10,11
8,Superior Incompleto,6133,Produtores Da Avicultura E Cunicultura,1522.9363098144531,-4,44,48
8,Superior Incompleto,6134,Produtores De Animais E Insetos Úteis,1338.9444444444443,3,6,3
8,Superior Incompleto,6201,Supervisores Na Exploração Agropecuária,3633.4083188939817,97,1399,1302
8,Superior Incompleto,6210,Trabalhadores Agropecuários Em Geral,1892.9356436374387,185,3038,2853
8,Superior Incompleto,6220,Trabalhadores De Apoio À Agricultura,1948.7534127910224,997,6601,5604
8,Superior Incompleto,6221,Trabalhadores Agrícolas Na Cultura De Gramíneas,2486.300477829551,208,2093,1885
8,Superior Incompleto,6222,Trabalhadores Agrícolas Na Cultura De Plantas Fibrosas,1798.0985596974692,-1,17,18
8,Superior Incompleto,6223,Trabalhadores Agrícolas Na Olericultura,1444.2515523151353,1,125,124
8,Superior Incompleto,6224,Trabalhadores Agrícolas No Cultivo De Flores E Plantas Ornamentais,1459.807075493966,23,283,260
8,Superior Incompleto,6225,Trabalhadores Agrícolas Na Fruticultura,2695.3358837900037,54,1019,965
8,Superior Incompleto,6226,Trabalhadores Agrícolas Nas Culturas De Plantas Estimulantes,1494.9186886037005,-8,172,180
8,Superior Incompleto,6227,Trabalhadores Agrícolas Na Cultura De Plantas Oleaginosas,1750.6716206480464,23,136,113
8,Superior Incompleto,6228,Trabalhadores Agrícolas Da Cultura De Especiarias E De Plantas Aromáticas E Medicinais,1563.2304992675781,2,10,8
8,Superior Incompleto,6230,Tratadores Polivalentes De Animais,1892.2488753429952,228,1177,949
8,Superior Incompleto,6231,Trabalhadores Na Pecuária De Animais De Grande Porte,1752.3395256172346,57,755,698
8,Superior Incompleto,6232,Trabalhadores Na Pecuária De Animais De Médio Porte,1615.9091421091252,85,505,420
8,Superior Incompleto,6233,Trabalhadores Na Avicultura E Cunicultura,1484.1229157326657,30,1017,987
8,Superior Incompleto,6234,Trabalhadores Na Criação De Insetos E Animais Úteis,1606.9805666779973,3,36,33
8,Superior Incompleto,6301,Supervisores Na Área Florestal E Aqüicultura,3145.0230949982865,-4,263,267
8,Superior Incompleto,6310,Pescadores Polivalentes,1106,1,2,1
8,Superior Incompleto,6311,Pescadores Profissionais Artesanais De Água Doce,2184.464618389423,-3,5,8
8,Superior Incompleto,6312,Pescadores De Água Costeira E Alto Mar,1700.7367030552455,-1,21,22
8,Superior Incompleto,6313,Criadores De Animais Aquáticos,1686.0960935393225,23,105,82
8,Superior Incompleto,6314,Trabalhadores De Apoio À Pesca,1644.6333414713542,-2,1,3
8,Superior Incompleto,6320,Trabalhadores Florestais Polivalentes,1681.5694289023863,21,104,83
8,Superior Incompleto,6321,Extrativistas E Reflorestadores De Espécies Produtoras De Madeira,1588.208313650822,14,565,551
8,Superior Incompleto,6322,Extrativistas Florestais De Espécies Produtoras De Gomas E Resinas,1146.4323942241735,-4,47,51
8,Superior Incompleto,6323,"Extrativistas Florestais De Espécies Produtoras De Fibras, Ceras E Óleos",66642,0,3,3
8,Superior Incompleto,6324,Extrativistas Florestais De Espécies Produtoras De Alimentos Silvestres,1091.166295369466,4,30,26
8,Superior Incompleto,6325,"Extrativistas Florestais De Espécies Produtoras De Substâncias Aromáticas, Medicinais E Tóxicas",981.125,1,3,2
8,Superior Incompleto,6326,Carvoejadores,1566.6929179283507,1,53,52
8,Superior Incompleto,6410,Trabalhadores Da Mecanização Agrícola,3129.9101196199676,232,3048,2816
8,Superior Incompleto,6420,Trabalhadores Da Mecanização Florestal,1893.3765535471139,12,205,193
8,Superior Incompleto,6430,Trabalhadores Da Irrigação E Drenagem,1973.5230682648714,16,125,109
8,Superior Incompleto,7101,Supervisores Da Extração Mineral,4510.781961133319,24,213,189
8,Superior Incompleto,7102,Supervisores Da Construção Civil,3438.031112892831,-48,3942,3990
8,Superior Incompleto,7111,Trabalhadores Da Extração De Minerais Sólidos,1852.96471336655,3,284,281
8,Superior Incompleto,7112,Trabalhadores De Extração De Minerais Sólidos (Operadores De Máquinas),3015.364073253239,-23,256,279
8,Superior Incompleto,7113,Trabalhadores Da Extração De Minerais Líquidos E Gasosos,2320.348078562477,3,233,230
8,Superior Incompleto,7114,Garimpeiros E Operadores De Salinas,1295.7528599330358,1,4,3
8,Superior Incompleto,7121,Trabalhadores De Beneficiamento De Minérios,3126.398253859012,26,150,124
8,Superior Incompleto,7122,Trabalhadores De Beneficiamento De Pedras Ornamentais,1766.2674437964642,25,372,347
8,Superior Incompleto,7151,Trabalhadores Na Operação De Máquinas De Terraplenagem E Fundações,2343.1836342820134,433,2004,1571
8,Superior Incompleto,7152,Trabalhadores De Estruturas De Alvenaria,1961.0613159250659,210,3326,3116
8,Superior Incompleto,7153,Montadores De Estruturas De Concreto Armado,3363.0824147688836,17,534,517
8,Superior Incompleto,7154,Trabalhadores Na Operação De Máquinas De Concreto Usinado E Afins,3044.060539311738,2,247,245
8,Superior Incompleto,7155,"Trabalhadores De Montagem De Estruturas De Madeira, Metal E Compósitos Em Obras Civis",2349.686015443999,61,1183,1122
8,Superior Incompleto,7156,Trabalhadores De Instalações Elétricas,3370.917014885598,-176,5174,5350
8,Superior Incompleto,7157,Aplicadores De Materiais Isolantes,1748.071781297096,-29,253,282
8,Superior Incompleto,7161,Revestidores De Concreto,3023.181532699343,0,34,34
8,Superior Incompleto,7162,Telhadores (Revestimentos Rígidos),1885.1390079690952,0,20,20
8,Superior Incompleto,7163,Vidraceiros (Revestimentos Rígidos),1707.6272724216167,-53,610,663
8,Superior Incompleto,7164,Gesseiros,1825.543789437908,8,251,243
8,Superior Incompleto,7165,"Aplicadores De Revestimentos Cerâmicos, Pastilhas, Pedras E Madeiras",1804.153465152804,39,388,349
8,Superior Incompleto,7166,Pintores De Obras E Revestidores De Interiores (Revestimentos Flexíveis),1870.246603256277,-24,981,1005
8,Superior Incompleto,7170,Ajudantes De Obras Civis,1811.3469447091652,484,9166,8682
8,Superior Incompleto,7201,"Supervisores De Usinagem, Conformação E Tratamento De Metais",8524.337280536392,-156,390,546
8,Superior Incompleto,7202,Supervisores Da Fabricação E Montagem Metalmecânica,4864.663090129879,-171,513,684
8,Superior Incompleto,7211,Ferramenteiros E Afins,3495.710187267708,-225,876,1101
8,Superior Incompleto,7212,Preparadores E Operadores De Máquinas-Ferramenta Convencionais,7621.931545837904,-310,4381,4691
8,Superior Incompleto,7213,Afiadores E Polidores De Metais,2416.1239071501846,-17,344,361
8,Superior Incompleto,7214,Operadores De Máquinas De Usinagem Cnc,4251.599311304861,-315,2274,2589
8,Superior Incompleto,7221,Trabalhadores De Forjamento De Metais,2367.302225521104,-8,138,146
8,Superior Incompleto,7222,Trabalhadores De Fundição De Metais Puros E De Ligas Metálicas,1858.7232260624553,1,553,552
8,Superior Incompleto,7223,Trabalhadores De Moldagem De Metais E De Ligas Metálicas,1795.555607607075,13,220,207
8,Superior Incompleto,7224,Trabalhadores De Trefilação E Estiramento De Metais Puros E Ligas Metálicas,2057.396569576695,-37,89,126
8,Superior Incompleto,7231,Trabalhadores De Tratamento Térmico De Metais,1909.9050277811348,-17,59,76
8,Superior Incompleto,7232,Trabalhadores De Tratamento De Superfícies De Metais E De Compósitos (Termoquímicos),1945.4275653504842,-30,171,201
8,Superior Incompleto,7233,"Trabalhadores Da Pintura De Equipamentos, Veículos, Estruturas Metálicas E De Compósitos",2767.170997624244,-77,962,1039
8,Superior Incompleto,7241,Encanadores E Instaladores De Tubulações,2564.8580854960032,-83,1216,1299
8,Superior Incompleto,7242,Trabalhadores De Traçagem E Montagem De Estruturas Metálicas E De Compósitos,2101.822884539839,151,2219,2068
8,Superior Incompleto,7243,Trabalhadores De Soldagem E Corte De Ligas Metálicas,4300.352921298332,4,3313,3309
8,Superior Incompleto,7244,Trabalhadores De Caldeiraria E Serralheria,5323.354989898317,101,2687,2586
8,Superior Incompleto,7245,Operadores De Máquinas De Conformação De Metais,2486.9265226897232,-92,812,904
8,Superior Incompleto,7246,Trançadores E Laceiros De Cabos De Aço,1738.5719199682537,-3,13,16
8,Superior Incompleto,7250,Ajustadores Mecânicos Polivalentes E Afins,2552.288435504948,-72,1690,1762
8,Superior Incompleto,7251,"Montadores De Máquinas, Aparelhos E Acessórios Em Linhas De Montagem",8137.0125417063055,-221,1129,1350
8,Superior Incompleto,7252,Montadores De Máquinas Industriais,2993.221889778536,147,1603,1456
8,Superior Incompleto,7253,Montadores De Máquinas Pesadas E Equipamentos Agrícolas,2574.674164462488,18,349,331
8,Superior Incompleto,7254,Mecânicos Montadores De Motores E Turboalimentadores,2766.699993034005,28,140,112
8,Superior Incompleto,7255,Montadores De Veículos Automotores (Linha De Montagem),2400.4328693539437,-91,1433,1524
8,Superior Incompleto,7256,Montadores De Sistemas E Estruturas De Aeronaves,2652.5619331586477,-2,50,52
8,Superior Incompleto,7257,Instaladores De Equipamentos De Refrigeração E Ventilação,2407.695338199336,-71,586,657
8,Superior Incompleto,7301,Supervisores De Montagens E Instalações Eletroeletrônicas,5850.707800506625,-133,387,520
8,Superior Incompleto,7311,Montadores De Equipamentos Eletroeletrônicos,2065.1437966323692,-123,5092,5215
8,Superior Incompleto,7312,Montadores De Aparelhos De Telecomunicações,1558.0420109985998,-48,165,213
8,Superior Incompleto,7313,Instaladores-Reparadores De  Linhas E Equipamentos De Telecomunicações,1562.1637512628413,-375,1868,2243
8,Superior Incompleto,7321,"Instaladores E Reparadores De Linhas E Cabos Elétricos, Telefônicos E De Comunicação De Dados",8180.696558069428,-37,4231,4268
8,Superior Incompleto,7401,Supervisores Da Mecânica De Precisão E Instrumentos Musicais,3049.4317238681288,-18,35,53
8,Superior Incompleto,7411,Mecânicos De Instrumentos De Precisão,2762.353494660346,-75,328,403
8,Superior Incompleto,7421,Confeccionadores De Instrumentos Musicais,2024.2401500883557,-3,12,15
8,Superior Incompleto,7501,Supervisores De Joalheria E Afins,2980.372219509549,-1,4,5
8,Superior Incompleto,7502,"Supervisores De Vidraria, Cerâmica E Afins",4709.32304983428,-7,13,20
8,Superior Incompleto,7510,Joalheiros E Lapidadores De Gemas,1698.2348498415313,8,126,118
8,Superior Incompleto,7511,Artesãos De Metais Preciosos E Semi-Preciosos,2044.7452740435458,-25,193,218
8,Superior Incompleto,7521,"Sopradores, Moldadores E Modeladores De Vidros E Afins",1726.8830938430062,-2,19,21
8,Superior Incompleto,7522,Trabalhadores Da Transformação De Vidros Planos,1718.5786740652607,-21,193,214
8,Superior Incompleto,7523,Ceramistas (Preparação E Fabricação),2225.2556023357583,-8,526,534
8,Superior Incompleto,7524,Vidreiros E Ceramistas (Arte E Decoração),1722.0971098610175,-2,31,33
8,Superior Incompleto,7601,Supervisores Da Indústria Têxtil,8810.904300899021,-102,275,377
8,Superior Incompleto,7602,Supervisores Na Indústria Do Curtimento,4355.215019226074,-6,5,11
8,Superior Incompleto,7603,Supervisores Na Confecção Do Vestuário,2571.9992846505493,-104,390,494
8,Superior Incompleto,7604,Supervisores Na Confecção De Calçados,4262.879623934293,-121,364,485
8,Superior Incompleto,7605,"Supervisores Da Confecção De Artefatos De Tecidos, Couros E Afins",2898.7475908496713,-32,142,174
8,Superior Incompleto,7606,Supervisores Das Artes Gráficas,3391.624316889014,-79,138,217
8,Superior Incompleto,7610,Trabalhadores Polivalentes Das Indústrias Têxteis,1826.5543795212052,-68,788,856
8,Superior Incompleto,7611,Trabalhadores Da Classificação De Fibras Têxteis E Lavagem De Lã,1858.2648873735768,13,71,58
8,Superior Incompleto,7612,Operadores Da Fiação,1549.6995196702717,-66,188,254
8,Superior Incompleto,7613,Operadores De Tear E Máquinas Similares,1799.1450107494197,-98,571,669
8,Superior Incompleto,7614,"Trabalhadores De Acabamento, Tingimento E Estamparia Das Indústrias Têxteis",1744.4256805173459,-75,413,488
8,Superior Incompleto,7618,Inspetores E Revisores De Produção Têxtil,1836.1461571943682,-109,843,952
8,Superior Incompleto,7620,Trabalhadores Polivalentes Do Curtimento De Couros E Peles,2136.262367476278,24,280,256
8,Superior Incompleto,7621,Trabalhadores Da Preparação Do Curtimento De Couros E Peles,1816.649386818447,4,19,15
8,Superior Incompleto,7622,Trabalhadores Do Curtimento De Couros E Peles,2103.7383455357926,-16,53,69
8,Superior Incompleto,7623,Trabalhadores Do Acabamento De Couros E Peles,1754.3929580436775,-13,50,63
8,Superior Incompleto,7630,Profissionais Polivalentes Da Confecção De Roupas,1784.8872798114448,-132,955,1087
8,Superior Incompleto,7631,Trabalhadores Da Preparação Da Confecção De Roupas,1772.7150365841724,-192,4646,4838
8,Superior Incompleto,7632,Operadores De Máquinas Para Costura De Peças Do Vestuário,1729.003361758049,-660,6150,6810
8,Superior Incompleto,7633,Operadores De Máquinas Para Bordado E Acabamento De Roupas,1544.2608714800517,-114,1193,1307
8,Superior Incompleto,7640,Trabalhadores Polivalentes Da Confecção De Calçados,1275.7311368045207,-112,4197,4309
8,Superior Incompleto,7641,Trabalhadores Da Preparação Da Confecção De Calçados,1494.1386490677348,-117,1522,1639
8,Superior Incompleto,7642,Operadores De Máquinas De Costurar E Montar Calçados,1439.2327917502105,-247,1422,1669
8,Superior Incompleto,7643,Trabalhadores De Acabamento De Calçados,1524.5041423405971,-98,617,715
8,Superior Incompleto,7650,Trabalhadores Polivalentes Da Confecção De Artefatos De Tecidos E Couros,1953.0385621682192,-7,33,40
8,Superior Incompleto,7651,"Trabalhadores Da Preparação De Artefatos De Tecidos, Couros E Tapeçaria",1573.3449453751246,-16,97,113
8,Superior Incompleto,7652,"Trabalhadores Da Confecção De Artefatos De Tecidos, Couros E Sintéticos",1714.7223936717799,-20,427,447
8,Superior Incompleto,7653,Operadores De Máquinas Na Confecção De Artefatos De  Couro,1632.7825728291023,-16,75,91
8,Superior Incompleto,7654,Trabalhadores Do Acabamento De Artefatos De Tecidos E Couros,1485.5306460731908,-3,122,125
8,Superior Incompleto,7661,Trabalhadores Da Pré-Impressão Gráfica,1993.741503537895,-266,2361,2627
8,Superior Incompleto,7662,Trabalhadores Da Impressão Gráfica,2084.686097803642,-225,1323,1548
8,Superior Incompleto,7663,Trabalhadores Do Acabamento Gráfico,1819.5115692210613,-152,1131,1283
8,Superior Incompleto,7664,Trabalhadores De Laboratório Fotográfico E Radiológico,1663.8277581838938,-53,199,252
8,Superior Incompleto,7681,"Trabalhadores De Tecelagem Manual, Tricô, Crochê, Rendas E Afins",1501.360755599381,-19,24,43
8,Superior Incompleto,7682,Trabalhadores Artesanais Da Confecção De Peças E Tecidos,1609.1592797545431,-2,48,50
8,Superior Incompleto,7683,Trabalhadores Artesanais Da Confecção De Calçados E Artefatos De Couros E Peles,1874.1886612141275,-29,237,266
8,Superior Incompleto,7686,Trabalhadores Tipográficos Linotipistas E Afins,1720.310616549792,1,44,43
8,Superior Incompleto,7687,Encadernadores E Recuperadores De Livros (Pequenos Lotes Ou A Unidade),1725.1470696226206,-4,29,33
8,Superior Incompleto,7701,"Supervisores Em Indústria De Madeira, Mobiliário E Da Carpintaria Veicular",2764.2001870664185,-42,294,336
8,Superior Incompleto,7711,Marceneiros E Afins,6764.797449876235,39,1874,1835
8,Superior Incompleto,7721,Trabalhadores De Tratamento E Preparação Da Madeira,1582.904916477664,-50,213,263
8,Superior Incompleto,7731,Operadores De Máquinas De Desdobramento Da Madeira,1710.796989149362,-75,195,270
8,Superior Incompleto,7732,Operadores De Máquinas De Aglomeração E Prensagem De Chapas,2324.929839439629,-15,34,49
8,Superior Incompleto,7733,Operadores De Usinagem Convencional De Madeira,2814.086578333949,-108,388,496
8,Superior Incompleto,7734,Operadores De Máquina De Usinar Madeira (Produção Em Série),1847.3757056737406,-39,155,194
8,Superior Incompleto,7735,Operadores De Máquinas De Usinagem De Madeira Cnc,2129.8323272807284,-53,158,211
8,Superior Incompleto,7741,Montadores De Móveis E Artefatos De Madeira,1916.7153688540286,-31,1533,1564
8,Superior Incompleto,7751,Trabalhadores De Arte E  Do Acabamento Em Madeira Do Mobiliário,1779.637416343422,-12,74,86
8,Superior Incompleto,7764,"Confeccionadores De Artefatos De Madeira, Móveis De Vime E Afins",1466.4736406148756,-39,60,99
8,Superior Incompleto,7771,Carpinteiros Navais,2413.6142442491323,5,10,5
8,Superior Incompleto,7772,Carpinteiros De Carrocerias E Carretas,1883.788350423177,-3,1,4
8,Superior Incompleto,7801,Supervisores De Trabalhadores De Embalagem E Etiquetagem,2872.950829290575,-74,118,192
8,Superior Incompleto,7811,Condutores De Processos Robotizados,2458.421067999315,-13,72,85
8,Superior Incompleto,7813,Operadores De Equipamentos Pilotados Remotamente,3192.480975303614,137,341,204
8,Superior Incompleto,7817,Trabalhadores Subaquáticos,2203.738615606023,-26,74,100
8,Superior Incompleto,7821,Operadores De Máquinas E Equipamentos De Elevação,2440.405462823536,-3,508,511
8,Superior Incompleto,7822,Operadores De Equipamentos De Movimentação De Cargas,2043.983664570186,-588,3275,3863
8,Superior Incompleto,7823,Motoristas De Veículos De Pequeno E Médio Porte,1895.4884801050762,299,10564,10265
8,Superior Incompleto,7824,"Motoristas De Ônibus Urbanos, Metropolitanos E Rodoviários",2709.688685051385,692,6888,6196
8,Superior Incompleto,7825,Motoristas De Veículos De Cargas Em Geral,2380.9506658165487,809,14669,13860
8,Superior Incompleto,7826,Operadores De Veículos Sobre Trilhos E Cabos Aéreos,2442.334000288002,6,149,143
8,Superior Incompleto,7827,Trabalhadores Aquaviários,1849.002615342593,60,593,533
8,Superior Incompleto,7828,Condutores De Animais E De Veículos De Tração Animal E Pedais,1799.6590645684137,-3,31,34
8,Superior Incompleto,7831,Trabalhadores De Manobras De Transportes Sobre Trilhos,1584.5477738484037,38,519,481
8,Superior Incompleto,7832,Trabalhadores De Cargas E Descargas De Mercadorias,1666.4275394605577,1010,15464,14454
8,Superior Incompleto,7841,Trabalhadores De Embalagem E De Etiquetagem,1913.3149498488601,-822,10177,10999
8,Superior Incompleto,7842,Alimentadores De Linhas De Produção,1963.008001027008,2570,60417,57847
8,Superior Incompleto,7911,Artesãos,1420.85056250021,9,62,53
8,Superior Incompleto,8101,"Supervisores De Produção Em Indústrias Químicas, Petroquímicas E Afins",6557.505089894516,-85,175,260
8,Superior Incompleto,8102,Supervisores De Produção Em Indústrias De Transformação De Plásticos E Borrachas,4933.0595520569395,-99,228,327
8,Superior Incompleto,8103,"Supervisores De Produção Em Indústrias De Produtos Farmacêuticos, Cosméticos E Afins",4024.1964957640344,-28,83,111
8,Superior Incompleto,8110,"Operadores Polivalentes De Equipamentos Em Indústrias Químicas, Petroquímicas E Afins",4032.4712179417465,-71,253,324
8,Superior Incompleto,8111,Operadores De Equipamentos De Moagem E Mistura De Materiais (Tratamentos Químicos E Afins),1962.6301251155503,-49,246,295
8,Superior Incompleto,8112,Operadores De Calcinação E De Tratamentos Químicos De Materiais Radioativos,2545.820997971755,1,21,20
8,Superior Incompleto,8113,Operadores De Equipamentos De Filtragem E Separação,3503.4422490988377,-13,113,126
8,Superior Incompleto,8114,"Operadores De Equipamentos De Destilação, Evaporação E Reação",2318.003024773193,-1,125,126
8,Superior Incompleto,8115,Operadores De Equipamentos De Produção E Refino De Petróleo E Gás,2972.8081942190074,0,50,50
8,Superior Incompleto,8116,Operadores De Equipamentos De Coqueificação,2715.912300901383,-2,103,105
8,Superior Incompleto,8117,"Operadores De Instalações E Máquinas De Produtos Plásticos, De Borracha E Moldadores De Parafinas",1985.8855312540504,-211,1891,2102
8,Superior Incompleto,8118,"Operadores De Máquinas E Instalações De Produtos Farmacêuticos, Cosméticos E Afins",1875.1468224695159,-85,892,977
8,Superior Incompleto,8121,Trabalhadores Da Fabricação De Munição E Explosivos Químicos,1820.4034854107022,-1,18,19
8,Superior Incompleto,8131,"Operadores De Processos Das Indústrias De Transformação De Produtos Químicos, Petroquímicos E Afins",2142.8465335628266,14,2289,2275
8,Superior Incompleto,8181,Laboratoristas Industriais Auxiliares,2237.811897564502,1847,6283,4436
8,Superior Incompleto,8201,Supervisores De Produção Em Indústrias Siderúrgicas,4406.89592862724,-8,65,73
8,Superior Incompleto,8202,Supervisores Na Fabricação De Materiais Para Construção (Vidros E Cerâmicas),3578.2207772340817,-65,157,222
8,Superior Incompleto,8211,Operadores De Instalações De Sinterização,1905.541091633912,30,255,225
8,Superior Incompleto,8212,Operadores De Fornos De Primeira  Fusão E Aciaria,2634.929548657531,-20,197,217
8,Superior Incompleto,8213,Operadores De Equipamentos De Laminação,3558.6528027553973,-15,194,209
8,Superior Incompleto,8214,Operadores De Equipamentos De Acabamento De Chapas E Metais,2796.2335196297563,-118,1054,1172
8,Superior Incompleto,8221,Forneiros Metalúrgicos (Segunda Fusão E Reaquecimento),2481.0544307824334,-6,29,35
8,Superior Incompleto,8231,"Operadores Na Preparação De Massas Para Abrasivo, Vidro, Cerâmica, Porcelana E Materiais De Construção",1848.5009419504163,6,76,70
8,Superior Incompleto,8232,"Operadores De Equipamentos De Fabricação  E Beneficiamento De Cristais, Vidros, Cerâmicas, Porcelanas, Fibras De Vidro, Abrasivos E Afins",2091.972153003437,-26,97,123
8,Superior Incompleto,8233,Operadores De Instalações E Equipamentos De Fabricação De Materiais De Construção,1589.3953287297868,43,352,309
8,Superior Incompleto,8281,Trabalhadores Da Fabricação De Cerâmica Estrutural Para Construção,1472.9249517208755,-6,157,163
8,Superior Incompleto,8301,Supervisores Da Fabricação De Celulose E Papel,4480.473444228702,-50,65,115
8,Superior Incompleto,8311,Preparadores De Pasta Para Fabricação De Papel,2780.7779665078297,-24,47,71
8,Superior Incompleto,8321,Operadores De Máquinas De Fabricar Papel E Papelão,2442.1692199787276,-29,280,309
8,Superior Incompleto,8331,Operadores De Máquinas Na Fabricação De Produtos De Papel E Papelão,1729.9067484379048,-11,331,342
8,Superior Incompleto,8332,Trabalhadores Artesanais De Produtos De Papel E Papelão,1591.7701806062778,-9,80,89
8,Superior Incompleto,8401,"Supervisores Da Fabricação De Alimentos, Bebidas E Fumo",4221.744470620298,-196,1216,1412
8,Superior Incompleto,8411,"Trabalhadores Da Indústria De Beneficiamento De Grãos, Cereais E Afins",1929.1723531108962,-39,137,176
8,Superior Incompleto,8412,Trabalhadores No Beneficiamento Do Sal,1364.666658528646,5,10,5
8,Superior Incompleto,8413,Trabalhadores Na Fabricação E Refino De Açúcar,10366.877104355955,-44,180,224
8,Superior Incompleto,8414,Trabalhadores Na Fabricação E Conservação De Alimentos,1693.94021543523,-30,1654,1684
8,Superior Incompleto,8415,Trabalhadores Na Pasteurização Do Leite E Na Fabricação De Laticínios  E Afins,1596.5817848500626,-54,878,932
8,Superior Incompleto,8416,"Trabalhadores Na Industrialização De Café, Cacau, Mate E De Produtos Afins",1487.50585681488,-10,42,52
8,Superior Incompleto,8417,"Trabalhadores Na Fabricação De Cachaça, Cerveja, Vinhos E Outras Bebidas",3644.3503081227873,-5,397,402
8,Superior Incompleto,8418,"Operadores De Equipamentos Na Fabricação De Pães, Massas Alimentícias, Doces, Chocolates E Achocolatados",1715.865663459742,-156,559,715
8,Superior Incompleto,8421,Cigarreiros E Beneficiadores De Fumo,2080.432722949007,101,1098,997
8,Superior Incompleto,8422,Charuteiros,1767.6666666666667,-1,1,2
8,Superior Incompleto,8481,Trabalhadores Artesanais Na Conservação De Alimentos,1734.7706595586362,-29,271,300
8,Superior Incompleto,8482,Trabalhadores Artesanais Na Pasteurização Do Leite E Na Fabricação De Laticínios E Afins,1502.4168719216123,-1,106,107
8,Superior Incompleto,8483,"Padeiros, Confeiteiros E Afins",1714.4861343672424,-320,4087,4407
8,Superior Incompleto,8484,Trabalhadores Na Degustação E Classificação De Grãos E Afins,2859.1613711642162,15,949,934
8,Superior Incompleto,8485,Magarefes E Afins,1694.5323767628556,-1123,8718,9841
8,Superior Incompleto,8486,Trabalhadores Artesanais Na Indústria Do Fumo,1511.5315748537826,13,98,85
8,Superior Incompleto,8601,Supervisores Da Produção De Utilidades,4231.012534986837,-71,527,598
8,Superior Incompleto,8611,"Operadores De Instalações De Geração E Distribuição De Energia Elétrica, Hidráulica, Térmica Ou Nuclear",2993.32323903416,-25,215,240
8,Superior Incompleto,8612,Operadores De Instalações De Distribuição De Energia Elétrica,3208.944935993976,14,90,76
8,Superior Incompleto,8621,Operadores De Máquinas A Vapor E Utilidades,3118.799375808478,-517,4068,4585
8,Superior Incompleto,8622,"Operadores De Instalações De Captação, Tratamento E Distribuição De Água",4702.521106740064,4,311,307
8,Superior Incompleto,8623,Operadores De Instalações De Captação E Esgotos,2698.889162178398,115,779,664
8,Superior Incompleto,8624,"Operadores De Instalações De Extração, Processamento, Envasamento E Distribuição De Gases",2161.393191731771,10,80,70
8,Superior Incompleto,8625,Operadores De Instalações De Refrigeração E Ar-Condicionado,2852.769834778377,-11,166,177
8,Superior Incompleto,9101,"Supervisores Em Serviços De Reparação E Manutenção De Máquinas E Equipamentos Industriais, Comerciais E Residenciais",4073.770421964669,-131,1367,1498
8,Superior Incompleto,9102,Supervisores Em Serviços De Reparação E Manutenção Veicular,4270.1154892327295,-31,724,755
8,Superior Incompleto,9109,"Supervisores De Outros Trabalhadores De Serviços De Reparação, Conservação E Manutenção",2999.871568467882,-5,22,27
8,Superior Incompleto,9111,"Mecânicos De Manutenção De Bombas, Motores, Compressores E Equipamentos De Transmissão",2498.559088542168,95,627,532
8,Superior Incompleto,9112,Mecânicos De Manutenção E Instalação De Aparelhos De  Climatização E Refrigeração,1858.7010744041668,-167,1118,1285
8,Superior Incompleto,9113,Mecânicos De Manutenção De Máquinas Industriais,2781.1364103144238,-643,7727,8370
8,Superior Incompleto,9131,Mecânicos De Manutenção De Máquinas Pesadas E Equipamentos Agrícolas,2844.2117005287487,199,1324,1125
8,Superior Incompleto,9141,Mecânicos De Manutenção Aeronáutica,2851.12207478821,-59,320,379
8,Superior Incompleto,9142,Mecânicos De Manutenção De Motores E Equipamentos Navais,3224.719624110631,6,31,25
8,Superior Incompleto,9143,Mecânicos De Manutenção Metroferroviária,1916.7663303498298,6,127,121
8,Superior Incompleto,9144,Mecânicos De Manutenção De Veículos Automotores,2424.700551346762,-5,6639,6644
8,Superior Incompleto,9151,Técnicos Em Manutenção E Reparação De Instrumentos De Medição E Precisão,2513.838373669679,15,278,263
8,Superior Incompleto,9152,Restauradores De Instrumentos Musicais,1874.6164332798548,4,11,7
8,Superior Incompleto,9153,Técnicos Em Manutenção E Reparação De Equipamentos Biomédicos,2613.903860844831,155,616,461
8,Superior Incompleto,9154,Reparadores De Equipamentos Fotográficos,3995.6749877929688,-2,5,7
8,Superior Incompleto,9191,Lubrificadores,2181.141000316638,-79,418,497
8,Superior Incompleto,9192,"Trabalhadores De Manutenção De Roçadeiras, Motoserras E Similares",3091.5447575162043,-49,314,363
8,Superior Incompleto,9193,Mecânicos De Manutenção De Bicicletas E Equipamentos Esportivos E De Ginástica,1561.7674495195276,-17,249,266
8,Superior Incompleto,9501,"Supervisores De Manutenção Eletroeletrônica Industrial, Comercial E Predial",4419.535004173923,-112,736,848
8,Superior Incompleto,9502,Supervisores De Manutenção Eletroeletrônica Veicular,2833.62683358028,-23,61,84
8,Superior Incompleto,9503,Supervisores De Manutenção Eletromecânica,5951.286890814095,-114,320,434
8,Superior Incompleto,9511,Eletricistas De Manutenção Eletroeletrônica,3132.8307963126877,-122,4399,4521
8,Superior Incompleto,9513,Instaladores E Mantenedores De Sistemas Eletroeletrônicos De Segurança,1800.8686793765646,345,4439,4094
8,Superior Incompleto,9531,"Eletricistas Eletrônicos De Manutenção Veicular (Aérea, Terrestre E Naval)",3134.7381658961954,18,839,821
8,Superior Incompleto,9541,"Instaladores E Mantenedores Eletromecânicos De Elevadores, Escadas E Portas Automáticas",2503.6695689190296,9,1313,1304
8,Superior Incompleto,9542,Reparadores De Aparelhos Eletrodomésticos,1795.578749540747,-32,89,121
8,Superior Incompleto,9543,Reparadores De Equipamentos De Escritório,1934.6233986302425,-54,182,236
8,Superior Incompleto,9911,Conservadores De Vias Permanentes (Trilhos),2586.7665310863067,-1,86,87
8,Superior Incompleto,9912,Mantenedores De Equipamentos De Parques De Diversões E Similares,1670.9915080520343,7,30,23
8,Superior Incompleto,9913,Reparadores De Carrocerias De Veículos,1838.0305736698358,-16,557,573
8,Superior Incompleto,9921,Trabalhadores Elementares De Serviços De Manutenção Veicular,1630.8183556996883,-51,612,663
8,Superior Incompleto,9922,Trabalhadores Operacionais De Conservação De Vias Permanentes (Exceto Trilhos),1962.1087524522547,-147,1650,1797
9,Superior Completo,0000,Não especificado,3432.1028122014386,2810,6492,3682
9,Superior Completo,0101,Oficiais Generais Das Forças Armadas,4274.490165118681,73,353,280
9,Superior Completo,0102,Oficiais Das Forças Armadas,7434.0995560852025,-3,35,38
9,Superior Completo,0103,Praças Das Forças Armadas,2802.439097893932,3,14,11
9,Superior Completo,0201,Oficiais Superiores Da Polícia Militar,2292.860009765625,-2,2,4
9,Superior Completo,0202,Capitães Da  Polícia Militar,1733.3333333333333,3,3,0
9,Superior Completo,0203,Tenentes Da Polícia Militar,2279.47998046875,0,1,1
9,Superior Completo,0211,Subtenentes E Sargentos Da Policia Militar,2292.4822048611113,-2,5,7
9,Superior Completo,0212,Cabos E Soldados Da Polícia Militar,4400,1,1,0
9,Superior Completo,0301,Oficiais Superiores Do Corpo De Bombeiros Militar,2554.2537689208984,-4,2,6
9,Superior Completo,0302,Oficiais Intermediários Do Corpo De Bombeiros Militar,2697.987518310547,-2,1,3
9,Superior Completo,0303,Tenentes Do Corpo De Bombeiros Militar,1500,2,2,0
9,Superior Completo,0311,Subtenentes E Sargentos Do Corpo De Bombeiros Militar,2720.82666015625,1,5,4
9,Superior Completo,0312,Cabos E Soldados Do Corpo De Bombeiros Militar,4061.5259765625,-4,3,7
9,Superior Completo,1111,Legisladores,4968.838614151063,-60,95,155
9,Superior Completo,1112,Dirigentes Gerais Da Administração Pública,5061.059092947809,118,706,588
9,Superior Completo,1113,Magistrados,2029.5122672526043,2,7,5
9,Superior Completo,1114,Dirigentes Do Serviço Público,5244.579336385484,1511,4125,2614
9,Superior Completo,1115,Gestores Públicos,6653.8707725140775,990,4175,3185
9,Superior Completo,1130,"Dirigentes De Povos Indígenas, De Quilombolas E Caiçaras",5474.345374334426,-10,15,25
9,Superior Completo,1141,Dirigentes De Partidos Políticos,9563.05921875,-5,10,15
9,Superior Completo,1142,Dirigentes E Administradores De Entidades Patronais E Dos Trabalhadores E De Outros Interesses Sócioeconômicos,7090.346739022263,0,79,79
9,Superior Completo,1143,Dirigentes E Administradores De Entidades Religiosas,7093.1002435967475,-38,82,120
9,Superior Completo,1144,Dirigentes E Administradores De Organizações Da Sociedade Civil Sem Fins Lucrativos,7407.7229605347575,2,138,136
9,Superior Completo,1210,Diretores Gerais,22738.81527253325,-550,5833,6383
9,Superior Completo,1221,"Diretores De Produção E Operações Em Empresa Agropecuária, Pesqueira , Aqüícola E Florestal",19195.900922229197,-15,158,173
9,Superior Completo,1222,"Diretores De Produção E Operações Em Empresa Da Indústria Extrativa, Transformação E De Serviços De Utilidade Pública",31321.946013122044,-140,406,546
9,Superior Completo,1223,Diretores De Operações De Obras Em Empresa De Construção,21327.5382078642,-94,378,472
9,Superior Completo,1224,Diretores De Operações Em Empresa Do Comércio,21384.414492754397,-125,394,519
9,Superior Completo,1225,"Diretores De Serviços De Turismo, De Alojamento E De Alimentação",11693.20338561494,-81,354,435
9,Superior Completo,1226,"Diretores De Operações De Serviços Em Empresa De Armazenamento, De Transporte E De Telecomunicação",15201.840481557636,-164,561,725
9,Superior Completo,1227,Diretores De Operações De Serviços Em Instituição De Intermediação Financeira,26028.122621740054,60,917,857
9,Superior Completo,1231,Diretores Administrativos E Financeiros,17679.417019582314,-2316,12517,14833
9,Superior Completo,1232,Diretores De Recursos Humanos E Relações De Trabalho,23058.782238324442,-60,880,940
9,Superior Completo,1233,Diretores De Comercialização E Marketing,29482.9676477347,-978,5518,6496
9,Superior Completo,1234,Diretores De Suprimentos E Afins,16712.359151457113,-177,367,544
9,Superior Completo,1236,Diretores De Tecnologia Da Informação,27385.19444292659,-92,1243,1335
9,Superior Completo,1237,Diretores De Pesquisa E Desenvolvimento,24084.34132432676,-180,457,637
9,Superior Completo,1238,Diretores De Manutenção,16716.116362887522,-80,265,345
9,Superior Completo,1311,"Diretores E Gerentes De Operações Em Empresa De Serviços Pessoais, Sociais E Culturais",8521.337166708772,-844,7377,8221
9,Superior Completo,1312,"Gestores E Especialistas De Operações Em Empresas, Secretarias E Unidades De Serviços De Saúde",6543.859314266546,-360,9455,9815
9,Superior Completo,1313,Diretores E Gerentes De Instituição De Serviços Educacionais,4622.561995664835,-1481,8555,10036
9,Superior Completo,1411,"Gerentes De Produção E Operações Em Empresa Agropecuária, Pesqueira, Aqüícola E Florestal",7630.155666997946,5,3336,3331
9,Superior Completo,1412,"Gerentes De Produção E Operações Em Empresa Da Indústria Extrativa, De Transformação E De Serviços De Utilidade Pública",9671.234024551559,-2331,19037,21368
9,Superior Completo,1413,Gerentes De Obras Em Empresa De Construção,9691.317815583901,244,7874,7630
9,Superior Completo,1414,Gerentes De Operações Comerciais E De Assistência Técnica,3809.051834750542,-4653,30164,34817
9,Superior Completo,1415,"Gerentes De Operações De Serviços Em Empresa De Turismo, De Alojamento E Alimentação",4119.836518913248,-2920,17599,20519
9,Superior Completo,1416,"Gerentes De Operações De Serviços Em Empresa De Transporte, De Comunicação E De Logística (Armazenagem E Distribuição)",7538.312399741917,-1592,14772,16364
9,Superior Completo,1417,Gerentes De Operações De Serviços Em Instituição De Intermediação Financeira,9520.106643670619,-3890,9076,12966
9,Superior Completo,1418,Gerentes Operacionais Da Aviação Civil,7873.636562870285,84,177,93
9,Superior Completo,1421,"Gerentes Administrativos, Financeiros, De Riscos E Afins",7420.5358717342015,-17675,112621,130296
9,Superior Completo,1422,Gerentes De Recursos Humanos E De Relações Do Trabalho,6651.493553215459,-3512,25510,29022
9,Superior Completo,1423,"Gerentes De Comercialização, Marketing E Comunicação",7030.1841218454565,22330,283109,260779
9,Superior Completo,1424,Gerentes De Suprimentos E Afins,8025.849951745255,-1368,9694,11062
9,Superior Completo,1425,Gerentes De Tecnologia Da Informação,13656.95035641876,1751,32766,31015
9,Superior Completo,1426,Gerentes De Pesquisa E Desenvolvimento E Afins,10745.757237754446,-580,9137,9717
9,Superior Completo,1427,Gerentes De Manutenção E Afins,5881.338654074683,-8805,13254,22059
9,Superior Completo,2011,Profissionais Da Biotecnologia,5827.874702987544,128,653,525
9,Superior Completo,2012,Profissionais Da Metrologia,5415.887164595804,-53,219,272
9,Superior Completo,2021,"Engenheiros De Controle E Automação, Engenheiros Mecatrônicos E Afins",8268.909242617592,507,2979,2472
9,Superior Completo,2030,Pesquisadores Das Ciências Biológicas,6158.5913572265035,180,1146,966
9,Superior Completo,2031,Pesquisadores Das Ciências Naturais E Exatas,6334.139588407104,979,3191,2212
9,Superior Completo,2032,Pesquisadores De Engenharia E Tecnologia,9699.176274209422,678,5804,5126
9,Superior Completo,2033,Pesquisadores Das Ciências Da Saúde,7634.107875048605,972,3258,2286
9,Superior Completo,2034,Pesquisadores Das Ciências Da Agricultura,4898.121606991899,185,881,696
9,Superior Completo,2035,Pesquisadores Das Ciências Sociais E Humanas,5504.970722474349,100,1090,990
9,Superior Completo,2041,Peritos Criminais E Judiciais,5081.7886962890625,2,7,5
9,Superior Completo,2111,Profissionais Da Matemática,7630.2394449927015,401,2663,2262
9,Superior Completo,2112,Profissionais De Estatística E Afins,7568.744558724193,623,2284,1661
9,Superior Completo,2122,Engenheiros Em Computação,11317.73209476991,5885,17575,11690
9,Superior Completo,2123,Administradores De Tecnologia Da Informação,7348.579954286575,2788,23750,20962
9,Superior Completo,2124,Analistas De Tecnologia Da Informação,6874.631685971959,35576,293180,257604
9,Superior Completo,2131,Físicos,5401.405328587063,-27,297,324
9,Superior Completo,2132,Químicos,5239.210733292525,-302,2286,2588
9,Superior Completo,2133,Profissionais Das Ciências Atmosféricas E Espaciais E De Astronomia,4750.044743387153,-8,92,100
9,Superior Completo,2134,"Geólogos, Oceanógrafos, Geofísicos E Afins",10004.358849847666,594,3171,2577
9,Superior Completo,2140,Engenheiros Ambientais E Afins,5844.858998681936,778,4141,3363
9,Superior Completo,2141,Arquitetos E Urbanistas,5800.917102587769,634,9157,8523
9,Superior Completo,2142,Engenheiros Civis E Afins,8963.89204015291,2074,48555,46481
9,Superior Completo,2143,"Engenheiros Eletricistas, Eletrônicos E Afins",8773.457732509056,861,16423,15562
9,Superior Completo,2144,Engenheiros Mecânicos E Afins,9895.305209402122,1088,14614,13526
9,Superior Completo,2145,Engenheiros Químicos E Afins,11704.15248964954,620,3411,2791
9,Superior Completo,2146,"Engenheiros Metalurgistas, De Materiais E Afins",9051.086598928916,-14,1191,1205
9,Superior Completo,2147,Engenheiros De Minas E Afins,10951.258940864758,1098,3394,2296
9,Superior Completo,2148,Engenheiros Agrimensores E Engenheiros Cartógrafos,6635.982631585436,12,362,350
9,Superior Completo,2149,"Engenheiros De Produção, Qualidade, Segurança E Afins",7767.279790967472,2318,27165,24847
9,Superior Completo,2151,Oficiais De Convés E Afins,6546.331844978569,656,5167,4511
9,Superior Completo,2152,Oficiais De Máquinas Da Marinha Mercante,9557.417586853406,419,2939,2520
9,Superior Completo,2153,Profissionais Da Pilotagem Aeronáutica,5712.432265275306,792,3930,3138
9,Superior Completo,2211,Biólogos E Afins,4373.647046235477,36,5520,5484
9,Superior Completo,2212,Biomédicos,3128.3964057565163,4897,26105,21208
9,Superior Completo,2221,Engenheiros Agrossilvipecuários,6247.373270836486,1585,11785,10200
9,Superior Completo,2222,Engenheiros De Alimentos E Afins,4034.1369269028364,11,681,670
9,Superior Completo,2232,Cirurgiões-Dentistas,4320.1389460997125,1695,14993,13298
9,Superior Completo,2233,Veterinários E Zootecnistas,4935.986743154899,1844,13232,11388
9,Superior Completo,2234,Farmacêuticos,4473.245532100374,20893,207999,187106
9,Superior Completo,2235,Enfermeiros E Afins,4196.702968926993,54972,323519,268547
9,Superior Completo,2236,Fisioterapeutas,2846.52790256223,13883,74927,61044
9,Superior Completo,2237,Nutricionistas,2738.9527051350374,5878,53868,47990
9,Superior Completo,2238,Fonoaudiólogos,2944.5299814889318,2287,18458,16171
9,Superior Completo,2239,"Terapeutas Ocupacionais, Ortoptistas E Psicomotricistas",3082.951382557392,936,10853,9917
9,Superior Completo,2241,Profissionais Da Educação Física,7316.463889540837,10598,87891,77293
9,Superior Completo,2251,Médicos Clínicos,8198.496915914966,2440,87819,85379
9,Superior Completo,2252,Médicos Em Especialidades Cirúrgicas,8029.726304319968,237,7216,6979
9,Superior Completo,2253,Médicos Em Medicina Diagnóstica E Terapêutica,18518.29920586611,86,1192,1106
9,Superior Completo,2261,Osteopatas E Quiropraxistas,2339.0933227539063,6,9,3
9,Superior Completo,2263,"Profissionais Das Terapias Criativas,Equoterápicas E Naturológicas",2411.8624498172494,108,370,262
9,Superior Completo,2311,Professores De Nível Superior Na Educação Infantil,3228.0192874928466,7404,113659,106255
9,Superior Completo,2312,Professores De Nível Superior Do Ensino Fundamental (Primeira A Quarta Séries),7987.176088873235,1564,150715,149151
9,Superior Completo,2313,Professores De Nível Superior No Ensino Fundamental De Quinta A Oitava Série,4354.3750636800905,6872,79694,72822
9,Superior Completo,2321,Professores Do Ensino Médio,3516.5642836803054,865,70056,69191
9,Superior Completo,2331,Professores Do Ensino Profissional,3526.0016292072437,-529,4701,5230
9,Superior Completo,2332,Instrutores De Ensino Profissional,5929.207913806338,2365,27043,24678
9,Superior Completo,2341,"Professores De Matemática, Estatística E Informática Do Ensino Superior",2390.3865692053546,-660,894,1554
9,Superior Completo,2342,"Professores De Ciências Físicas, Químicas E Afins Do Ensino Superior",4877.757583647397,-53,505,558
9,Superior Completo,2343,"Professores De Arquitetura E Urbanismo, Engenharia, Geofísica E Geologia Do Ensino Superior",2999.0094245553796,-777,596,1373
9,Superior Completo,2344,Professores De Ciências Biológicas E Da Saúde Do Ensino Superior,5984.540388178947,-1986,10782,12768
9,Superior Completo,2345,Professores Na Área De Formação Pedagógica Do Ensino Superior,3979.4964224854116,-13823,27403,41226
9,Superior Completo,2346,Professores Nas Áreas De Língua E Literatura Do Ensino Superior,10276.135234766898,-1153,37254,38407
9,Superior Completo,2347,Professores De Ciências Humanas Do Ensino Superior,3542.0162429906477,-1899,2043,3942
9,Superior Completo,2348,"Professores De Ciências Econômicas, Administrativas E Contábeis Do Ensino Superior",3786.124655684498,-110,5149,5259
9,Superior Completo,2349,Professores De Artes Do Ensino Superior,2708.3248512481982,263,2281,2018
9,Superior Completo,2392,Professores De Educação Especial,14350.033738503087,1599,10033,8434
9,Superior Completo,2394,"Programadores, Avaliadores E Orientadores De Ensino",3020.9824787779326,1437,89386,87949
9,Superior Completo,2410,Advogados,5737.722336545948,4392,60415,56023
9,Superior Completo,2412,Procuradores E Advogados Públicos,7242.176703462496,20,341,321
9,Superior Completo,2413,Tabeliães E Registradores,3591.1857767120773,-90,1087,1177
9,Superior Completo,2422,Membros Do Ministério Público,4140.9953111436635,4,23,19
9,Superior Completo,2423,Delegados De Polícia,5335.509928385417,-1,1,2
9,Superior Completo,2424,Defensores Públicos E Procuradores Da Assistência Judiciária,5562.963228798148,8,119,111
9,Superior Completo,2429,Profissionais Da Inteligência,6679.896765518908,60,178,118
9,Superior Completo,2511,Profissionais Em Pesquisa E Análise Antropológica Sociológica,5071.036196805213,17,674,657
9,Superior Completo,2512,Economistas,5406.468825274918,518,27727,27209
9,Superior Completo,2513,Profissionais Em Pesquisa E Análise Geográfica,4935.745052693614,22,370,348
9,Superior Completo,2514,Filósofos,3693.1583353678384,-4,4,8
9,Superior Completo,2515,Psicólogos E Psicanalistas,3063.651949545694,11453,50162,38709
9,Superior Completo,2516,Assistentes Sociais E Economistas Domésticos,4101.31872722817,6868,38863,31995
9,Superior Completo,2521,Administradores,5179.547041837417,12265,140163,127898
9,Superior Completo,2522,Contadores E Afins,5084.158688232179,-741,107247,107988
9,Superior Completo,2523,Secretárias(Os) Executivas(Os) E Afins,3873.108049317209,303,36801,36498
9,Superior Completo,2524,Profissionais De Recursos Humanos,4043.537416118667,11068,108062,96994
9,Superior Completo,2525,Profissionais De Administração Ecônomico-Financeira,6366.621688573177,10099,61051,50952
9,Superior Completo,2526,Profissionais Da Administração Dos Serviços De Segurança,9351.150138248244,97,1225,1128
9,Superior Completo,2527,"Profissionais De Planejamento, Programação E Controles Logisticos",4244.949255745692,5387,19151,13764
9,Superior Completo,2531,Profissionais De Publicidade,7755.410665054866,-654,39929,40583
9,Superior Completo,2532,Profissionais De Comercializacão E Consultoria De Serviços Bancários,8454.924459320537,-6348,40807,47155
9,Superior Completo,2533,"Corretores De Valores, Ativos Financeiros, Mercadorias E Derivativos",6452.618030779803,128,2089,1961
9,Superior Completo,2534,Profissionais De Mídias Digitais E Afins,3426.877448266507,2454,5658,3204
9,Superior Completo,2541,Auditores Fiscais E Técnicos Da Receita Federal,6825.605697631836,-16,20,36
9,Superior Completo,2542,Auditores Fiscais Da Previdência Social,8643.235555013021,-12,12,24
9,Superior Completo,2543,Auditores Fiscais Do Trabalho,4315.107875448612,-48,159,207
9,Superior Completo,2544,Fiscais De Tributos Estaduais E Municipais,5024.614912702047,164,1041,877
9,Superior Completo,2545,Profissionais Da Fiscalização De Atividades Urbanas,3507.756270204741,94,266,172
9,Superior Completo,2611,Profissionais Do Jornalismo,4651.10802318791,-1246,19748,20994
9,Superior Completo,2612,Profissionais Da Informação,4303.669364249788,146,17875,17729
9,Superior Completo,2613,Arquivistas E Museólogos,3083.2823467166945,-41,1510,1551
9,Superior Completo,2614,"Filólogos,Tradutores ,Intérpretes E Afins",3806.4623014166536,815,3960,3145
9,Superior Completo,2615,Profissionais Da Escrita,5355.767686460644,-72,1940,2012
9,Superior Completo,2616,Editores,5075.654589128977,-314,1534,1848
9,Superior Completo,2617,"Locutores, Comentaristas E Repórteres De Mídias Audiovisuais",4270.678527086709,-259,4213,4472
9,Superior Completo,2618,Fotógrafos Profissionais,3054.481078885702,-63,1021,1084
9,Superior Completo,2619,Assistentes De Direção (Tv) E Continuístas,4699.0387022943105,6,59,53
9,Superior Completo,2621,Produtores Artísticos E Culturais,3692.3947230452795,154,4442,4288
9,Superior Completo,2622,Diretores De Espetáculos E Afins,10937.640266978855,-134,433,567
9,Superior Completo,2623,Cenógrafos,4031.1238134696723,-376,2053,2429
9,Superior Completo,2624,"Artistas Visuais,Desenhistas Industriais E Conservadores-Restauradores De Bens Culturais",4581.915519642294,1276,37377,36101
9,Superior Completo,2625,Atores,15739.390007686252,-34,246,280
9,Superior Completo,2626,"Músicos Compositores, Arranjadores, Regentes E Musicólogos",2815.8045788354534,-63,501,564
9,Superior Completo,2627,Músicos Intérpretes,3023.565399572699,112,655,543
9,Superior Completo,2628,Artistas Da Dança (Exceto Dança Tradicional E Popular),4916.307152777835,-320,2634,2954
9,Superior Completo,2629,Designer De Interiores De Nível Superior,4080.126892792706,-59,528,587
9,Superior Completo,2631,"Ministros De Culto, Missionários, Teólogos E Profissionais Assemelhados",3289.219035019815,50,1266,1216
9,Superior Completo,2711,Chefes De Cozinha E Afins,3276.4396504408182,-163,4965,5128
9,Superior Completo,3001,Técnicos Em Mecatrônica,4813.765434064919,28,2045,2017
9,Superior Completo,3003,Técnicos Em Eletromecânica,3690.634186806443,-27,2137,2164
9,Superior Completo,3011,Técnicos De Laboratório Industrial,3216.2217520269046,530,9413,8883
9,Superior Completo,3012,Técnicos De Apoio À Bioengenharia,3214.650601341611,-32,110,142
9,Superior Completo,3111,Técnicos Químicos,3858.8694609753934,440,10615,10175
9,Superior Completo,3112,"Técnicos De Produção De Indústrias Químicas, Petroquímicas, Refino De Petróleo, Gás E Afins",4768.332139113853,-34,157,191
9,Superior Completo,3113,"Técnicos Em Materiais, Produtos Cerâmicos E Vidros",4257.664793408607,-14,114,128
9,Superior Completo,3114,Técnicos Em Fabricação De Produtos Plásticos E De Borracha,4684.610102362381,-32,480,512
9,Superior Completo,3115,"Técnicos Em Controle Ambiental, Utilidades E Tratamento De Efluentes",3879.7178620618856,1127,5921,4794
9,Superior Completo,3116,Técnicos Têxteis,4412.8788724492015,-38,275,313
9,Superior Completo,3117,Coloristas,3084.0316735561487,-49,535,584
9,Superior Completo,3121,Técnicos Em Construção Civil (Edificações),3531.2892308768446,5806,37065,31259
9,Superior Completo,3122,Técnicos Em Construção Civil (Obras De Infraestrutura),4026.464865009946,181,2504,2323
9,Superior Completo,3123,Técnicos Em Geomática,4137.201063389307,456,3677,3221
9,Superior Completo,3131,Técnicos Em Eletricidade E Eletrotécnica,5528.778813436678,-717,13421,14138
9,Superior Completo,3132,Técnicos Em Eletrônica,3220.0420356929762,-1403,26251,27654
9,Superior Completo,3133,Técnicos Em Telecomunicações,3117.822507782489,-1350,6357,7707
9,Superior Completo,3134,Técnicos Em Calibração E Instrumentação,4827.730578071554,-211,2058,2269
9,Superior Completo,3135,Técnicos Em Fotônica,2036.430809239316,-17,638,655
9,Superior Completo,3141,"Técnicos Mecânicos Na Fabricação E Montagem De Máquinas, Sistemas E Instrumentos",5501.817240937458,-101,6530,6631
9,Superior Completo,3142,Técnicos Mecânicos (Ferramentas),5325.627240576945,-67,1189,1256
9,Superior Completo,3143,Técnicos Em Mecânica Veicular,4910.9549198202485,312,1806,1494
9,Superior Completo,3144,"Técnicos Mecânicos Na Manutenção De Máquinas, Sistemas E Instrumentos",4360.999904983117,-204,4823,5027
9,Superior Completo,3146,Técnicos Em Metalurgia (Estruturas Metálicas),5526.089655361962,-119,786,905
9,Superior Completo,3147,Técnicos Em Siderurgia,9242.786425980248,-12,243,255
9,Superior Completo,3148,Especialistas Em Inspeções Industriais,6766.139359107261,84,520,436
9,Superior Completo,3161,Técnicos Em Geologia,4389.1144714051,86,572,486
9,Superior Completo,3163,Técnicos Em Mineração,5147.207304744799,546,1602,1056
9,Superior Completo,3171,Técnicos De Desenvolvimento De Sistemas E Aplicações,5576.456282937699,2056,68117,66061
9,Superior Completo,3172,Técnicos De Suporte E Monitoração Ao Usuário De Tecnologia Da Informação.,2421.1123081140076,303,37751,37448
9,Superior Completo,3180,"Desenhistas Técnicos, Em Geral",3737.85668255756,1,4274,4273
9,Superior Completo,3181,Desenhistas Técnicos Da Construção Civil E Arquitetura,2805.1397891935544,283,3217,2934
9,Superior Completo,3182,Desenhistas Técnicos Da Mecânica,4327.602040799874,115,1039,924
9,Superior Completo,3183,"Desenhistas Técnicos Em Eletricidade, Eletrônica, Eletromecânica, Calefação, Ventilação E Refrigeração",3046.2118251720412,8,236,228
9,Superior Completo,3184,Desenhistas Técnicos De Produtos E Serviços Diversos,3582.914659718747,-246,3263,3509
9,Superior Completo,3185,Desenhistas Projetistas De Construção Civil E Arquitetura,3237.4406835071304,3146,15514,12368
9,Superior Completo,3186,Desenhistas Projetistas Da Mecânica,4389.946543841599,768,8925,8157
9,Superior Completo,3187,Desenhistas Projetistas Da Eletrônica,3534.2450030028194,151,3180,3029
9,Superior Completo,3188,Desenhistas Projetistas E Modelistas De Produtos E Serviços Diversos,4939.72938798724,757,8533,7776
9,Superior Completo,3191,Técnicos Do Vestuário,3734.901784439001,0,197,197
9,Superior Completo,3192,Técnicos Do Mobiliário E Afins,2324.37583667652,23,104,81
9,Superior Completo,3201,Técnicos Em Biologia,2425.9622015024456,14,285,271
9,Superior Completo,3211,Técnicos Agrícolas,3505.9376675790845,1601,14570,12969
9,Superior Completo,3212,Técnicos Florestais,3144.9829159069286,405,2602,2197
9,Superior Completo,3213,Técnicos Em Aqüicultura,2722.0893029053727,8,83,75
9,Superior Completo,3221,Tecnólogos E Técnicos Em Terapias Complementares E Estéticas,2393.976774439863,2726,18232,15506
9,Superior Completo,3222,Técnicos E Auxiliares De Enfermagem,2300.0533106678213,126,78907,78781
9,Superior Completo,3223,Técnicos Em Óptica E Optometria,2549.6406355928784,-10,358,368
9,Superior Completo,3224,Técnicos De Odontologia,1867.600714171862,744,8196,7452
9,Superior Completo,3225,Técnicos Em Próteses Ortopédicas,3075.9242043417007,25,104,79
9,Superior Completo,3226,Técnicos De Imobilizações Ortopédicas,1860.7171873943114,48,256,208
9,Superior Completo,3231,Técnicos Em Pecuária,4122.726072926474,40,327,287
9,Superior Completo,3241,Tecnólogos E Técnicos Em Métodos De Diagnósticos E Terapêutica,4768.786226694818,1205,9329,8124
9,Superior Completo,3242,Técnicos De Laboratórios De Saúde E Bancos De Sangue,2405.414506223272,1751,14824,13073
9,Superior Completo,3250,"Enólogos, Perfumistas E Aromistas",5716.959018757773,-10,349,359
9,Superior Completo,3251,Técnico Em Farmácia E Em Manipulação Farmacêutica,2245.3075251703835,-159,3593,3752
9,Superior Completo,3252,"Técnicos Em Produção, Conservação  E De Qualidade De Alimentos",2967.7197017698027,267,4800,4533
9,Superior Completo,3253,Técnicos De Apoio À Biotecnologia,2970.3521148945847,83,274,191
9,Superior Completo,3281,Técnicos Em Necrópsia E Taxidermistas,2528.852192570613,5,45,40
9,Superior Completo,3311,Professores De Nível Médio Na Educação Infantil,2657.607830960754,14121,116180,102059
9,Superior Completo,3312,Professores De Nível Médio No Ensino Fundamental,4517.259892911085,3123,69501,66378
9,Superior Completo,3313,Professores De Nível Médio No Ensino Profissionalizante,2138.9490220683506,100,4688,4588
9,Superior Completo,3321,Professores Leigos No Ensino Fundamental,2206.1901003335765,526,4869,4343
9,Superior Completo,3322,Professores Práticos No Ensino Profissionalizante,2710.2237204475614,-408,2477,2885
9,Superior Completo,3331,Instrutores E Professores De Cursos Livres,3140.075411649635,-4625,47676,52301
9,Superior Completo,3341,Inspetores De Alunos E Afins,1754.2829948302497,2781,23000,20219
9,Superior Completo,3411,"Pilotos De Aviação Comercial, Mecânicos De Vôo E Afins",5374.01310068309,159,1231,1072
9,Superior Completo,3412,"Técnicos Marítimos, Fluviários E Pescadores De Convés",3895.567841763945,7,236,229
9,Superior Completo,3413,Técnicos Marítimos E Fluviários De Máquinas,2948.1671670753008,-26,234,260
9,Superior Completo,3421,Especialistas Em Logística De Transportes,3266.1326660747463,744,33795,33051
9,Superior Completo,3422,Despachantes Aduaneiros,3422.514413016337,62,1136,1074
9,Superior Completo,3423,Técnicos Em Transportes Rodoviários,3598.867057223501,-90,8959,9049
9,Superior Completo,3424,Técnicos Em Transportes Metroferroviários,3354.568818362932,-395,538,933
9,Superior Completo,3425,Técnicos Em Transportes Aéreos,4146.5667499035535,66,5711,5645
9,Superior Completo,3426,Técnicos Em Transportes Por Vias Navegáveis E Operações Portuárias,5721.305551503072,-60,975,1035
9,Superior Completo,3511,Técnicos Em Contabilidade,4390.557032010757,-924,6967,7891
9,Superior Completo,3513,Técnicos Em Administração,3888.92240761424,600,13411,12811
9,Superior Completo,3514,Serventuários Da Justiça E Afins,2755.6751025291355,2980,26899,23919
9,Superior Completo,3515,"Técnicos Em Secretariado, Taquígrafos E Estenotipistas",2256.7454751183127,-111,12817,12928
9,Superior Completo,3516,Técnicos Em Segurança Do Trabalho,3660.599389866805,3864,50340,46476
9,Superior Completo,3517,Técnicos De Seguros E Afins,4064.9678048284227,408,16499,16091
9,Superior Completo,3518,Agentes De Investigação E Identificação,3509.0237468709624,2,29,27
9,Superior Completo,3519,Técnicos Da Inteligência,4392.502850551502,46,158,112
9,Superior Completo,3522,Agentes Da Saúde E Do Meio Ambiente,3849.109539372613,2793,13567,10774
9,Superior Completo,3523,Agentes  Fiscais Metrológicos E De Qualidade,3397.4784244872844,-142,2229,2371
9,Superior Completo,3524,Profissionais De Direitos Autorais E De Avaliacão De Produtos Dos Meios De Comunicação,4053.821969636603,18,273,255
9,Superior Completo,3532,Técnicos Em Operações E Serviços Bancários,4345.116495073466,-1646,2711,4357
9,Superior Completo,3541,Especialistas Em Promoção De Produtos E Vendas,3626.2346353960475,16405,186726,170321
9,Superior Completo,3542,Compradores,5171.066926108843,3215,47303,44088
9,Superior Completo,3543,Analistas De Comércio Exterior,4830.033861143142,512,13113,12601
9,Superior Completo,3544,Leiloeiros E Avaliadores,3027.0405398943535,45,904,859
9,Superior Completo,3545,Corretores De Seguros,2018.9132190476782,26,650,624
9,Superior Completo,3546,Corretores De Imóveis E De Grãos,5422.652846832063,43,1576,1533
9,Superior Completo,3547,Representantes Comerciais Autônomos,2775.2136652292893,84,1654,1570
9,Superior Completo,3548,Técnicos Em Serviços De Turismo E Organização De Eventos,2791.9111929186574,-1520,14629,16149
9,Superior Completo,3711,Técnicos Em Biblioteconomia,2774.3066476105396,-553,1717,2270
9,Superior Completo,3712,Técnicos Em Museologia E Afins,3312.2561064603037,-20,68,88
9,Superior Completo,3713,Técnicos Em Artes Gráficas,3324.353316052214,-120,378,498
9,Superior Completo,3714,Recreadores,2343.2780298272546,680,16265,15585
9,Superior Completo,3721,Captadores De Imagens Em Movimento,4458.934783785317,-11,1001,1012
9,Superior Completo,3722,Operadores De Rede De Teleprocessamento E Afins,1659.3681741436444,1954,6869,4915
9,Superior Completo,3731,Técnicos De Operação De Registros Sonoro/Audiovisuais,3219.1729024358874,236,3272,3036
9,Superior Completo,3732,Supervisores Operacionais E Técnicos Em Mídias Audiovisuais,4994.96490237112,-547,1474,2021
9,Superior Completo,3741,Técnicos Em Áudio,3337.5641307427545,-152,1219,1371
9,Superior Completo,3742,Técnicos Em Cenografia,2403.7410826568735,35,558,523
9,Superior Completo,3743,Técnicos Em Operação De Aparelhos De Projeção,2612.498162857609,-13,108,121
9,Superior Completo,3744,"Técnicos Em Montagem, Edição E Finalização De Mídia Audiovisual",3420.99848406336,656,4555,3899
9,Superior Completo,3751,"Designers De Interiores, De Vitrines E Visual Merchandiser E Afins (Nível Médio)",3070.8677763326555,-53,4223,4276
9,Superior Completo,3761,Dançarinos Tradicionais E Populares,4111.994749475822,-7,70,77
9,Superior Completo,3762,Artistas De Circo (Circenses),2873.838832141631,-2,48,50
9,Superior Completo,3763,"Apresentadores De Eventos, Programas E Espetáculos",3834.785548605147,-73,459,532
9,Superior Completo,3764,Modelos,2591.5320313094003,-16,114,130
9,Superior Completo,3771,Atletas Profissionais,4316.64286429419,69,1710,1641
9,Superior Completo,3772,Árbitros Desportivos,3968.9664217209383,-12,181,193
9,Superior Completo,3911,"Planejadores, Programadores E Controladores De Produção E Manutenção",4543.308850018595,184,51103,50919
9,Superior Completo,3912,Técnicos De Controle Da Produção,12497.749687639567,5469,72740,67271
9,Superior Completo,3951,Técnicos De Apoio Em Pesquisa E Desenvolvimento,4930.866935403178,621,8579,7958
9,Superior Completo,4101,Supervisores Administrativos,4960.728472222014,-14840,100677,115517
9,Superior Completo,4102,"Supervisores De Serviços Financeiros, De Câmbio E De Controle",4998.44529615016,-2032,29527,31559
9,Superior Completo,4110,"Agentes, Assistentes E Auxiliares Administrativos",2222.9884781142473,43141,957336,914195
9,Superior Completo,4121,Operadores De Equipamentos De Entrada E Transmissão De Dados,2273.4571615448117,-814,5270,6084
9,Superior Completo,4122,Contínuos,1683.6726960469523,-688,4892,5580
9,Superior Completo,4131,Auxiliares De Contabilidade,2655.076334226341,3055,153756,150701
9,Superior Completo,4132,Escriturários De Serviços Bancários,2827.1272257587625,2065,39690,37625
9,Superior Completo,4141,Almoxarifes E Armazenistas,2219.096816276769,10609,95602,84993
9,Superior Completo,4142,Apontadores E Conferentes,2755.2210910110393,-337,15290,15627
9,Superior Completo,4151,"Auxiliares De Serviços De Documentação, Informação E Pesquisa",2444.1392152633252,100,3863,3763
9,Superior Completo,4152,"Trabalhadores Nos Serviços De Classificação E Entregas De Correspondências, Encomendas E Publicações",1823.3050701745806,-1274,741,2015
9,Superior Completo,4153,Trabalhadores Em Registros E Informações Em Saúde,4380.185703822544,3,5,2
9,Superior Completo,4201,Supervisores De Atendimento Ao Público E De Pesquisa,3281.4119039572156,-5068,22878,27946
9,Superior Completo,4211,Caixas E Bilheteiros (Exceto Caixa De Banco),1964.2459995220565,-5554,71371,76925
9,Superior Completo,4212,Coletadores De Apostas E De Jogos,1295.7883421151628,-306,1264,1570
9,Superior Completo,4213,Cobradores E Afins,2443.421926670222,-502,16522,17024
9,Superior Completo,4221,Recepcionistas,2091.103533680674,395,143051,142656
9,Superior Completo,4222,Operadores De Telefonia,2070.5256848523186,-1535,8468,10003
9,Superior Completo,4223,Operadores De Telemarketing E Afins,1642.520274625671,1524,140775,139251
9,Superior Completo,4231,Despachantes Documentalistas E Afins,2342.7425802456623,213,1040,827
9,Superior Completo,4241,Entrevistadores E Recenseadores,2159.6409395774294,-142,3497,3639
9,Superior Completo,4242,Aplicadores De Provas E Afins,1819.8863071555522,131,226,95
9,Superior Completo,5101,"Supervisores Dos Serviços De Transporte, Turismo, Hotelaria E Administração De Edifícios",3452.2724472686264,-512,6306,6818
9,Superior Completo,5102,Supervisores De Lavanderia,3231.8099798979583,-24,420,444
9,Superior Completo,5103,"Supervisores Dos Serviços De Proteção, Segurança E Outros",5950.932552650431,-202,2949,3151
9,Superior Completo,5111,Trabalhadores De Segurança E Atendimento Aos Usuários Nos Transportes,1907.8632526547829,-259,1495,1754
9,Superior Completo,5112,Fiscais E Cobradores Dos Transportes Coletivos,1812.6750982759627,-387,2177,2564
9,Superior Completo,5114,Guias De Turismo,2223.8502881751,1,208,207
9,Superior Completo,5115,Condutores De Turismo,2100.8468023681644,8,30,22
9,Superior Completo,5121,Trabalhadores Dos Serviços Domésticos Em Geral,1750.073371642346,58,383,325
9,Superior Completo,5131,Mordomos E Governantas,2991.3790139127536,-87,1319,1406
9,Superior Completo,5132,Cozinheiros,1885.5498587397426,-164,16978,17142
9,Superior Completo,5133,"Camareiros, Roupeiros E Afins",2148.1626488395905,44,2216,2172
9,Superior Completo,5134,"Trabalhadores No Atendimento Em Estabelecimentos De Serviços De Alimentação, Bebidas E Hotelaria",1886.239751750381,-958,28864,29822
9,Superior Completo,5135,Trabalhadores Auxiliares Nos Serviços De Alimentação,1941.9557482086693,1194,15225,14031
9,Superior Completo,5136,"Churrasqueiros, Pizzaiolos E Sushimen",1900.2685497595005,-64,1075,1139
9,Superior Completo,5141,Trabalhadores Nos Serviços De Administração De Edifícios,1646.3946828557741,26,5269,5243
9,Superior Completo,5142,"Trabalhadores Nos Serviços De Coleta De Resíduos, De Limpeza E Conservação De Áreas Públicas",2747.570583035384,-119,5232,5351
9,Superior Completo,5143,Trabalhadores Nos  Serviços De Manutenção De Edificações,2525.590012384956,1201,32416,31215
9,Superior Completo,5151,Trabalhadores Em Serviços De Promoção E Apoio À Saúde,2608.482736275726,3583,9477,5894
9,Superior Completo,5152,Auxiliares De Laboratório Da Saúde,2133.800994465574,734,17375,16641
9,Superior Completo,5153,"Trabalhadores De Atenção, Defesa E Proteção A Pessoas Em Situação De Risco E Adolescentes Em Conflito Com A Lei",2365.9965219335995,2640,25043,22403
9,Superior Completo,5161,Trabalhadores Nos Serviços De Embelezamento E Higiene,2310.2069358307153,-266,923,1189
9,Superior Completo,5162,"Cuidadores De Crianças, Jovens, Adultos E Idosos",2278.6521678598897,2146,13135,10989
9,Superior Completo,5163,"Tintureiros, Lavadeiros E Afins, A Máquina",1969.499581061248,6,1411,1405
9,Superior Completo,5164,"Lavadores E Passadores De Roupa, A Mão",1368.7062353015924,-4,70,74
9,Superior Completo,5165,Trabalhadores Dos Serviços Funerários,1848.7035582752605,147,804,657
9,Superior Completo,5166,Trabalhadores Auxiliares Dos Serviços Funerários,2086.9862991809196,0,41,41
9,Superior Completo,5167,Astrólogos E Numerólogos,2003.4649658203125,-2,0,2
9,Superior Completo,5168,Esotéricos E Paranormais,1716.0621007283528,0,7,7
9,Superior Completo,5169,Trabalhadores Nos Serviços De Arte Corporal,3320,1,2,1
9,Superior Completo,5171,"Bombeiros, Salva-Vidas E Afins",2619.5035013910724,419,3288,2869
9,Superior Completo,5172,"Policiais, Guardas-Civis Municipais E Agentes De Trânsito",2696.5842404550135,-175,610,785
9,Superior Completo,5173,Vigilantes E Guardas De Segurança,2557.1143038280957,511,20376,19865
9,Superior Completo,5174,"Porteiros, Vigias E Afins",1769.3614437856024,1429,30106,28677
9,Superior Completo,5191,Motociclistas E Ciclistas De Entregas Rápidas,1436.1655372025286,-120,3080,3200
9,Superior Completo,5192,Trabalhadores Da Coleta E Seleção De Material Reciclável,1944.6973889688343,25,232,207
9,Superior Completo,5193,"Trabalhadores De Serviços Veterinários, De Higiene E Estética De Animais Domésticos",1706.1386149642792,392,3288,2896
9,Superior Completo,5198,Profissionais Do Sexo,33000,1,1,0
9,Superior Completo,5199,Outros Trabalhadores Dos Serviços,1866.2219725777618,-147,4394,4541
9,Superior Completo,5201,Supervisores De Vendas E De Prestação De Serviços,4437.745365423119,-5024,52206,57230
9,Superior Completo,5211,Operadores Do Comércio Em Lojas E Mercados,1836.106877212926,-7621,397217,404838
9,Superior Completo,5231,Instaladores De Produtos E Acessórios,1764.738051337757,-68,335,403
9,Superior Completo,5241,Vendedores Em Domicílio,2055.728796039675,-122,16893,17015
9,Superior Completo,5242,"Vendedores Em Bancas, Quiosques E Barracas",1583.1938167623268,-69,461,530
9,Superior Completo,5243,Vendedores Ambulantes,1775.2564518548797,-125,405,530
9,Superior Completo,6110,Produtores Agropecuários Em Geral,3509.863773533555,11,36,25
9,Superior Completo,6120,Produtores Agrícolas Polivalentes,2288.4068519905823,-1,36,37
9,Superior Completo,6121,Produtores Agrícolas Na Cultura De Gramíneas,1955.398462204706,6,13,7
9,Superior Completo,6122,Produtores Agrícolas Na Cultura De Plantas Fibrosas,1224,-1,1,2
9,Superior Completo,6123,Produtores Agrícolas Na Olericultura,1909.025388590495,-3,6,9
9,Superior Completo,6124,Produtores Agrícolas No Cultivo De Flores E Plantas Ornamentais,1421.1379191080728,8,12,4
9,Superior Completo,6125,Produtores Agrícolas Na Fruticultura,2623.5527413181526,2,25,23
9,Superior Completo,6126,Produtores Agrícolas Na Cultura De Plantas Estimulantes,2653.77001953125,1,2,1
9,Superior Completo,6127,Produtores Agrícolas Na Cultura De Plantas Oleaginosas,3443.6666666666665,-1,1,2
9,Superior Completo,6128,Produtores De Especiarias E De Plantas Aromáticas E Medicinais,4573.34375,2,4,2
9,Superior Completo,6130,Produtores Em Pecuária Polivalente,2152.5424540468625,1,16,15
9,Superior Completo,6131,Produtores Em Pecuária De Animais De Grande Porte,2541.005420793806,5,27,22
9,Superior Completo,6132,Produtores Em Pecuária De Animais De Médio Porte,2425.68361070421,-4,17,21
9,Superior Completo,6133,Produtores Da Avicultura E Cunicultura,1776.3250749860492,25,85,60
9,Superior Completo,6134,Produtores De Animais E Insetos Úteis,2379.9308723000922,2,10,8
9,Superior Completo,6201,Supervisores Na Exploração Agropecuária,5485.392145492394,536,5943,5407
9,Superior Completo,6210,Trabalhadores Agropecuários Em Geral,2038.9397250162756,-7,3091,3098
9,Superior Completo,6220,Trabalhadores De Apoio À Agricultura,2831.141578703019,374,5326,4952
9,Superior Completo,6221,Trabalhadores Agrícolas Na Cultura De Gramíneas,3119.0605472511743,129,1629,1500
9,Superior Completo,6222,Trabalhadores Agrícolas Na Cultura De Plantas Fibrosas,1862.4869968761097,-5,23,28
9,Superior Completo,6223,Trabalhadores Agrícolas Na Olericultura,1570.2760365009494,-8,85,93
9,Superior Completo,6224,Trabalhadores Agrícolas No Cultivo De Flores E Plantas Ornamentais,1662.1525434084663,-9,209,218
9,Superior Completo,6225,Trabalhadores Agrícolas Na Fruticultura,2797.5943832889293,28,719,691
9,Superior Completo,6226,Trabalhadores Agrícolas Nas Culturas De Plantas Estimulantes,1932.0592533983033,-5,106,111
9,Superior Completo,6227,Trabalhadores Agrícolas Na Cultura De Plantas Oleaginosas,1708.133666318949,37,220,183
9,Superior Completo,6228,Trabalhadores Agrícolas Da Cultura De Especiarias E De Plantas Aromáticas E Medicinais,3150.4152764214414,1,8,7
9,Superior Completo,6230,Tratadores Polivalentes De Animais,2094.0649003230783,140,1084,944
9,Superior Completo,6231,Trabalhadores Na Pecuária De Animais De Grande Porte,2953.5585122518255,42,693,651
9,Superior Completo,6232,Trabalhadores Na Pecuária De Animais De Médio Porte,2036.7443643297695,52,441,389
9,Superior Completo,6233,Trabalhadores Na Avicultura E Cunicultura,1742.7729201550828,10,801,791
9,Superior Completo,6234,Trabalhadores Na Criação De Insetos E Animais Úteis,2310.0029410229417,7,72,65
9,Superior Completo,6301,Supervisores Na Área Florestal E Aqüicultura,4514.423947409208,45,1297,1252
9,Superior Completo,6310,Pescadores Polivalentes,1532.4666697184243,-1,3,4
9,Superior Completo,6312,Pescadores De Água Costeira E Alto Mar,1872.441595699625,-3,23,26
9,Superior Completo,6313,Criadores De Animais Aquáticos,1894.598819318244,5,99,94
9,Superior Completo,6314,Trabalhadores De Apoio À Pesca,3564.5847309253836,0,8,8
9,Superior Completo,6320,Trabalhadores Florestais Polivalentes,2147.255096431873,34,167,133
9,Superior Completo,6321,Extrativistas E Reflorestadores De Espécies Produtoras De Madeira,2152.4124425918476,14,536,522
9,Superior Completo,6322,Extrativistas Florestais De Espécies Produtoras De Gomas E Resinas,1328.403055498677,-15,29,44
9,Superior Completo,6323,"Extrativistas Florestais De Espécies Produtoras De Fibras, Ceras E Óleos",3175.6749877929688,0,2,2
9,Superior Completo,6324,Extrativistas Florestais De Espécies Produtoras De Alimentos Silvestres,1390.386006449605,2,12,10
9,Superior Completo,6325,"Extrativistas Florestais De Espécies Produtoras De Substâncias Aromáticas, Medicinais E Tóxicas",1436.1408360799155,3,6,3
9,Superior Completo,6326,Carvoejadores,1750.4002984408673,9,58,49
9,Superior Completo,6410,Trabalhadores Da Mecanização Agrícola,3281.3822269639145,277,2897,2620
9,Superior Completo,6420,Trabalhadores Da Mecanização Florestal,2144.3549979910513,180,431,251
9,Superior Completo,6430,Trabalhadores Da Irrigação E Drenagem,4113.255025757048,54,202,148
9,Superior Completo,7101,Supervisores Da Extração Mineral,8606.5940504844,49,1282,1233
9,Superior Completo,7102,Supervisores Da Construção Civil,5368.734637793552,329,10390,10061
9,Superior Completo,7111,Trabalhadores Da Extração De Minerais Sólidos,2245.042290912389,84,466,382
9,Superior Completo,7112,Trabalhadores De Extração De Minerais Sólidos (Operadores De Máquinas),3138.714877500322,77,449,372
9,Superior Completo,7113,Trabalhadores Da Extração De Minerais Líquidos E Gasosos,4235.906499679567,38,534,496
9,Superior Completo,7114,Garimpeiros E Operadores De Salinas,2219.6550089518228,-1,5,6
9,Superior Completo,7121,Trabalhadores De Beneficiamento De Minérios,2438.061211513498,17,133,116
9,Superior Completo,7122,Trabalhadores De Beneficiamento De Pedras Ornamentais,6475.864495865553,4,233,229
9,Superior Completo,7151,Trabalhadores Na Operação De Máquinas De Terraplenagem E Fundações,2526.2959245066377,279,2013,1734
9,Superior Completo,7152,Trabalhadores De Estruturas De Alvenaria,2085.124907496859,69,2499,2430
9,Superior Completo,7153,Montadores De Estruturas De Concreto Armado,2543.1535643207703,9,387,378
9,Superior Completo,7154,Trabalhadores Na Operação De Máquinas De Concreto Usinado E Afins,2674.562698578711,51,348,297
9,Superior Completo,7155,"Trabalhadores De Montagem De Estruturas De Madeira, Metal E Compósitos Em Obras Civis",3327.8953053393684,42,1097,1055
9,Superior Completo,7156,Trabalhadores De Instalações Elétricas,3807.1089845775946,-23,5946,5969
9,Superior Completo,7157,Aplicadores De Materiais Isolantes,3490.2466950660964,-36,188,224
9,Superior Completo,7161,Revestidores De Concreto,2416.3710024409565,0,24,24
9,Superior Completo,7162,Telhadores (Revestimentos Rígidos),2976.4647623697915,-3,5,8
9,Superior Completo,7163,Vidraceiros (Revestimentos Rígidos),1908.6147293762606,20,367,347
9,Superior Completo,7164,Gesseiros,1860.783794510992,16,198,182
9,Superior Completo,7165,"Aplicadores De Revestimentos Cerâmicos, Pastilhas, Pedras E Madeiras",2060.9672485725023,19,241,222
9,Superior Completo,7166,Pintores De Obras E Revestidores De Interiores (Revestimentos Flexíveis),2090.269118784509,-32,732,764
9,Superior Completo,7170,Ajudantes De Obras Civis,2105.9305391970092,405,6605,6200
9,Superior Completo,7201,"Supervisores De Usinagem, Conformação E Tratamento De Metais",7868.397829532573,-117,1303,1420
9,Superior Completo,7202,Supervisores Da Fabricação E Montagem Metalmecânica,8258.75333982561,-794,1601,2395
9,Superior Completo,7211,Ferramenteiros E Afins,5062.183836908917,-167,1308,1475
9,Superior Completo,7212,Preparadores E Operadores De Máquinas-Ferramenta Convencionais,5406.5723868457935,-177,4033,4210
9,Superior Completo,7213,Afiadores E Polidores De Metais,2769.027054134066,-7,252,259
9,Superior Completo,7214,Operadores De Máquinas De Usinagem Cnc,3844.1125579674967,-2,2236,2238
9,Superior Completo,7221,Trabalhadores De Forjamento De Metais,2085.1691111768773,-27,81,108
9,Superior Completo,7222,Trabalhadores De Fundição De Metais Puros E De Ligas Metálicas,4134.836742515857,-30,460,490
9,Superior Completo,7223,Trabalhadores De Moldagem De Metais E De Ligas Metálicas,2173.920067091089,30,229,199
9,Superior Completo,7224,Trabalhadores De Trefilação E Estiramento De Metais Puros E Ligas Metálicas,2077.4117748789185,15,114,99
9,Superior Completo,7231,Trabalhadores De Tratamento Térmico De Metais,3532.036067893844,-9,96,105
9,Superior Completo,7232,Trabalhadores De Tratamento De Superfícies De Metais E De Compósitos (Termoquímicos),2313.0821125391158,19,181,162
9,Superior Completo,7233,"Trabalhadores Da Pintura De Equipamentos, Veículos, Estruturas Metálicas E De Compósitos",3315.050701378426,-66,800,866
9,Superior Completo,7241,Encanadores E Instaladores De Tubulações,3463.92532264001,-254,1220,1474
9,Superior Completo,7242,Trabalhadores De Traçagem E Montagem De Estruturas Metálicas E De Compósitos,2945.8465244989457,80,1758,1678
9,Superior Completo,7243,Trabalhadores De Soldagem E Corte De Ligas Metálicas,5323.941064031119,70,2842,2772
9,Superior Completo,7244,Trabalhadores De Caldeiraria E Serralheria,3343.759108470733,76,2244,2168
9,Superior Completo,7245,Operadores De Máquinas De Conformação De Metais,3302.840884015974,-47,642,689
9,Superior Completo,7246,Trançadores E Laceiros De Cabos De Aço,2523.4011739095054,-2,10,12
9,Superior Completo,7250,Ajustadores Mecânicos Polivalentes E Afins,2793.1704979487763,19,969,950
9,Superior Completo,7251,"Montadores De Máquinas, Aparelhos E Acessórios Em Linhas De Montagem",4274.410237631745,31,1050,1019
9,Superior Completo,7252,Montadores De Máquinas Industriais,2803.8818539378653,2,1427,1425
9,Superior Completo,7253,Montadores De Máquinas Pesadas E Equipamentos Agrícolas,2108.397030980651,13,200,187
9,Superior Completo,7254,Mecânicos Montadores De Motores E Turboalimentadores,3357.7802243869637,-9,124,133
9,Superior Completo,7255,Montadores De Veículos Automotores (Linha De Montagem),2627.836515039273,2,1514,1512
9,Superior Completo,7256,Montadores De Sistemas E Estruturas De Aeronaves,3431.2776960406386,17,97,80
9,Superior Completo,7257,Instaladores De Equipamentos De Refrigeração E Ventilação,2334.5656782285996,-28,654,682
9,Superior Completo,7301,Supervisores De Montagens E Instalações Eletroeletrônicas,9516.105943895764,-196,1798,1994
9,Superior Completo,7311,Montadores De Equipamentos Eletroeletrônicos,3015.1335104822174,-90,4580,4670
9,Superior Completo,7312,Montadores De Aparelhos De Telecomunicações,1677.3460060780442,-24,242,266
9,Superior Completo,7313,Instaladores-Reparadores De  Linhas E Equipamentos De Telecomunicações,1829.2781998688545,-400,1600,2000
9,Superior Completo,7321,"Instaladores E Reparadores De Linhas E Cabos Elétricos, Telefônicos E De Comunicação De Dados",5694.050803156408,173,4768,4595
9,Superior Completo,7401,Supervisores Da Mecânica De Precisão E Instrumentos Musicais,6473.557898198942,-47,118,165
9,Superior Completo,7411,Mecânicos De Instrumentos De Precisão,3545.141656243841,-37,374,411
9,Superior Completo,7421,Confeccionadores De Instrumentos Musicais,2469.58857468395,2,16,14
9,Superior Completo,7501,Supervisores De Joalheria E Afins,4614.986075265067,4,16,12
9,Superior Completo,7502,"Supervisores De Vidraria, Cerâmica E Afins",5498.621133547218,-47,136,183
9,Superior Completo,7510,Joalheiros E Lapidadores De Gemas,1869.7485761251714,-23,75,98
9,Superior Completo,7511,Artesãos De Metais Preciosos E Semi-Preciosos,2241.6672498328544,-27,136,163
9,Superior Completo,7521,"Sopradores, Moldadores E Modeladores De Vidros E Afins",1589.86303347633,3,25,22
9,Superior Completo,7522,Trabalhadores Da Transformação De Vidros Planos,1944.0555972962313,-8,136,144
9,Superior Completo,7523,Ceramistas (Preparação E Fabricação),2670.1012484516086,26,440,414
9,Superior Completo,7524,Vidreiros E Ceramistas (Arte E Decoração),13176.650214233232,-14,34,48
9,Superior Completo,7601,Supervisores Da Indústria Têxtil,4343.3353524891745,-227,614,841
9,Superior Completo,7602,Supervisores Na Indústria Do Curtimento,4416.3813587535515,-6,8,14
9,Superior Completo,7603,Supervisores Na Confecção Do Vestuário,3547.4785130162986,-140,824,964
9,Superior Completo,7604,Supervisores Na Confecção De Calçados,4463.455566156592,-113,442,555
9,Superior Completo,7605,"Supervisores Da Confecção De Artefatos De Tecidos, Couros E Afins",4690.300406758378,-24,316,340
9,Superior Completo,7606,Supervisores Das Artes Gráficas,5590.170158543706,-287,559,846
9,Superior Completo,7610,Trabalhadores Polivalentes Das Indústrias Têxteis,2179.7839227416875,-29,511,540
9,Superior Completo,7611,Trabalhadores Da Classificação De Fibras Têxteis E Lavagem De Lã,2081.125914140181,2,68,66
9,Superior Completo,7612,Operadores Da Fiação,1817.3999488864972,-27,170,197
9,Superior Completo,7613,Operadores De Tear E Máquinas Similares,2087.676296329423,-19,408,427
9,Superior Completo,7614,"Trabalhadores De Acabamento, Tingimento E Estamparia Das Indústrias Têxteis",2430.634724456305,-18,297,315
9,Superior Completo,7618,Inspetores E Revisores De Produção Têxtil,19991.734562531266,2,607,605
9,Superior Completo,7620,Trabalhadores Polivalentes Do Curtimento De Couros E Peles,1646.4793417411938,4,116,112
9,Superior Completo,7621,Trabalhadores Da Preparação Do Curtimento De Couros E Peles,2063.307100423177,-2,6,8
9,Superior Completo,7622,Trabalhadores Do Curtimento De Couros E Peles,1617.503871725063,10,67,57
9,Superior Completo,7623,Trabalhadores Do Acabamento De Couros E Peles,1928.8401851823937,6,72,66
9,Superior Completo,7630,Profissionais Polivalentes Da Confecção De Roupas,2689.521539421712,-204,1196,1400
9,Superior Completo,7631,Trabalhadores Da Preparação Da Confecção De Roupas,1807.680902925024,23,2978,2955
9,Superior Completo,7632,Operadores De Máquinas Para Costura De Peças Do Vestuário,2060.3208438698744,-391,4787,5178
9,Superior Completo,7633,Operadores De Máquinas Para Bordado E Acabamento De Roupas,2034.0655892783368,-79,835,914
9,Superior Completo,7640,Trabalhadores Polivalentes Da Confecção De Calçados,1334.0326470047185,123,1494,1371
9,Superior Completo,7641,Trabalhadores Da Preparação Da Confecção De Calçados,1550.1714526030664,-5,872,877
9,Superior Completo,7642,Operadores De Máquinas De Costurar E Montar Calçados,3837.944417595406,-71,387,458
9,Superior Completo,7643,Trabalhadores De Acabamento De Calçados,1770.7896179323825,-30,475,505
9,Superior Completo,7650,Trabalhadores Polivalentes Da Confecção De Artefatos De Tecidos E Couros,2636.653678919731,-3,23,26
9,Superior Completo,7651,"Trabalhadores Da Preparação De Artefatos De Tecidos, Couros E Tapeçaria",1748.369163634285,13,74,61
9,Superior Completo,7652,"Trabalhadores Da Confecção De Artefatos De Tecidos, Couros E Sintéticos",1801.012368257879,-4,262,266
9,Superior Completo,7653,Operadores De Máquinas Na Confecção De Artefatos De  Couro,1571.3701043421927,-6,62,68
9,Superior Completo,7654,Trabalhadores Do Acabamento De Artefatos De Tecidos E Couros,1495.3009430507443,-4,104,108
9,Superior Completo,7661,Trabalhadores Da Pré-Impressão Gráfica,2970.056339629214,-622,4027,4649
9,Superior Completo,7662,Trabalhadores Da Impressão Gráfica,2715.163165814326,-169,1248,1417
9,Superior Completo,7663,Trabalhadores Do Acabamento Gráfico,2462.8872992029806,-30,954,984
9,Superior Completo,7664,Trabalhadores De Laboratório Fotográfico E Radiológico,2710.6638982484837,-66,318,384
9,Superior Completo,7681,"Trabalhadores De Tecelagem Manual, Tricô, Crochê, Rendas E Afins",1626.8024216577824,-6,31,37
9,Superior Completo,7682,Trabalhadores Artesanais Da Confecção De Peças E Tecidos,1861.446436299906,-5,44,49
9,Superior Completo,7683,Trabalhadores Artesanais Da Confecção De Calçados E Artefatos De Couros E Peles,6005.590473469836,-12,208,220
9,Superior Completo,7686,Trabalhadores Tipográficos Linotipistas E Afins,2062.5929684564107,-37,32,69
9,Superior Completo,7687,Encadernadores E Recuperadores De Livros (Pequenos Lotes Ou A Unidade),1893.3054514567057,0,44,44
9,Superior Completo,7701,"Supervisores Em Indústria De Madeira, Mobiliário E Da Carpintaria Veicular",3576.629206365258,-103,582,685
9,Superior Completo,7711,Marceneiros E Afins,2516.6334721904695,38,1186,1148
9,Superior Completo,7721,Trabalhadores De Tratamento E Preparação Da Madeira,1650.300373590293,-2,136,138
9,Superior Completo,7731,Operadores De Máquinas De Desdobramento Da Madeira,1706.1313784578476,5,148,143
9,Superior Completo,7732,Operadores De Máquinas De Aglomeração E Prensagem De Chapas,2495.6817922925193,-16,18,34
9,Superior Completo,7733,Operadores De Usinagem Convencional De Madeira,3213.90747845345,-20,292,312
9,Superior Completo,7734,Operadores De Máquina De Usinar Madeira (Produção Em Série),2160.0561541665725,-15,97,112
9,Superior Completo,7735,Operadores De Máquinas De Usinagem De Madeira Cnc,2478.163439543757,-27,150,177
9,Superior Completo,7741,Montadores De Móveis E Artefatos De Madeira,2264.6419547123,27,963,936
9,Superior Completo,7751,Trabalhadores De Arte E  Do Acabamento Em Madeira Do Mobiliário,2129.2065288916565,-5,56,61
9,Superior Completo,7764,"Confeccionadores De Artefatos De Madeira, Móveis De Vime E Afins",3515.5705759085863,-3,18,21
9,Superior Completo,7771,Carpinteiros Navais,2891.4727851019966,-2,5,7
9,Superior Completo,7772,Carpinteiros De Carrocerias E Carretas,1486.2437438964844,-2,2,4
9,Superior Completo,7801,Supervisores De Trabalhadores De Embalagem E Etiquetagem,4333.916470687116,-83,416,499
9,Superior Completo,7811,Condutores De Processos Robotizados,5608.148378501261,-13,101,114
9,Superior Completo,7813,Operadores De Equipamentos Pilotados Remotamente,3372.342927140082,199,573,374
9,Superior Completo,7817,Trabalhadores Subaquáticos,2187.665940544822,10,181,171
9,Superior Completo,7821,Operadores De Máquinas E Equipamentos De Elevação,3984.782831491196,13,733,720
9,Superior Completo,7822,Operadores De Equipamentos De Movimentação De Cargas,2554.4305759372546,-98,4733,4831
9,Superior Completo,7823,Motoristas De Veículos De Pequeno E Médio Porte,1898.2514215606552,840,12994,12154
9,Superior Completo,7824,"Motoristas De Ônibus Urbanos, Metropolitanos E Rodoviários",2589.1206532609986,46,3243,3197
9,Superior Completo,7825,Motoristas De Veículos De Cargas Em Geral,2189.527068329473,1632,15907,14275
9,Superior Completo,7826,Operadores De Veículos Sobre Trilhos E Cabos Aéreos,2633.551847717584,13,316,303
9,Superior Completo,7827,Trabalhadores Aquaviários,1995.0883430853974,250,1115,865
9,Superior Completo,7828,Condutores De Animais E De Veículos De Tração Animal E Pedais,1813.428213282994,9,25,16
9,Superior Completo,7831,Trabalhadores De Manobras De Transportes Sobre Trilhos,1831.1326481048504,26,463,437
9,Superior Completo,7832,Trabalhadores De Cargas E Descargas De Mercadorias,2091.3964555163698,846,11630,10784
9,Superior Completo,7841,Trabalhadores De Embalagem E De Etiquetagem,1880.483363570686,65,5725,5660
9,Superior Completo,7842,Alimentadores De Linhas De Produção,2110.5545412370375,4370,46492,42122
9,Superior Completo,7911,Artesãos,2144.9214031535657,13,105,92
9,Superior Completo,8101,"Supervisores De Produção Em Indústrias Químicas, Petroquímicas E Afins",7051.910459944769,-151,1217,1368
9,Superior Completo,8102,Supervisores De Produção Em Indústrias De Transformação De Plásticos E Borrachas,6942.149262071387,-36,960,996
9,Superior Completo,8103,"Supervisores De Produção Em Indústrias De Produtos Farmacêuticos, Cosméticos E Afins",6369.108843496662,-106,860,966
9,Superior Completo,8110,"Operadores Polivalentes De Equipamentos Em Indústrias Químicas, Petroquímicas E Afins",4905.762024786786,-45,576,621
9,Superior Completo,8111,Operadores De Equipamentos De Moagem E Mistura De Materiais (Tratamentos Químicos E Afins),2153.969278127354,-32,290,322
9,Superior Completo,8112,Operadores De Calcinação E De Tratamentos Químicos De Materiais Radioativos,3638.7343792695497,7,49,42
9,Superior Completo,8113,Operadores De Equipamentos De Filtragem E Separação,5049.430973440489,-486,477,963
9,Superior Completo,8114,"Operadores De Equipamentos De Destilação, Evaporação E Reação",7371.159567559777,-2,234,236
9,Superior Completo,8115,Operadores De Equipamentos De Produção E Refino De Petróleo E Gás,3202.764652199297,-62,125,187
9,Superior Completo,8116,Operadores De Equipamentos De Coqueificação,3019.9651776775354,-1,165,166
9,Superior Completo,8117,"Operadores De Instalações E Máquinas De Produtos Plásticos, De Borracha E Moldadores De Parafinas",1981.0717742572597,19,1825,1806
9,Superior Completo,8118,"Operadores De Máquinas E Instalações De Produtos Farmacêuticos, Cosméticos E Afins",2109.127245786504,-104,1111,1215
9,Superior Completo,8121,Trabalhadores Da Fabricação De Munição E Explosivos Químicos,1969.2022850934197,1,17,16
9,Superior Completo,8131,"Operadores De Processos Das Indústrias De Transformação De Produtos Químicos, Petroquímicos E Afins",2415.673930249924,471,4215,3744
9,Superior Completo,8181,Laboratoristas Industriais Auxiliares,2989.4640881544174,878,8213,7335
9,Superior Completo,8201,Supervisores De Produção Em Indústrias Siderúrgicas,6656.447683760171,15,549,534
9,Superior Completo,8202,Supervisores Na Fabricação De Materiais Para Construção (Vidros E Cerâmicas),5111.473457094118,-75,481,556
9,Superior Completo,8211,Operadores De Instalações De Sinterização,2425.645806075282,9,368,359
9,Superior Completo,8212,Operadores De Fornos De Primeira  Fusão E Aciaria,3180.3092063834747,-9,247,256
9,Superior Completo,8213,Operadores De Equipamentos De Laminação,3293.3024278930825,2,205,203
9,Superior Completo,8214,Operadores De Equipamentos De Acabamento De Chapas E Metais,2831.104809064545,-75,1649,1724
9,Superior Completo,8221,Forneiros Metalúrgicos (Segunda Fusão E Reaquecimento),2951.811854249966,-14,35,49
9,Superior Completo,8231,"Operadores Na Preparação De Massas Para Abrasivo, Vidro, Cerâmica, Porcelana E Materiais De Construção",2670.3289576483908,-5,56,61
9,Superior Completo,8232,"Operadores De Equipamentos De Fabricação  E Beneficiamento De Cristais, Vidros, Cerâmicas, Porcelanas, Fibras De Vidro, Abrasivos E Afins",2635.2012003319032,-17,118,135
9,Superior Completo,8233,Operadores De Instalações E Equipamentos De Fabricação De Materiais De Construção,3361.174650543494,11,251,240
9,Superior Completo,8281,Trabalhadores Da Fabricação De Cerâmica Estrutural Para Construção,1528.3498647054037,8,91,83
9,Superior Completo,8301,Supervisores Da Fabricação De Celulose E Papel,6650.49522219723,-53,362,415
9,Superior Completo,8311,Preparadores De Pasta Para Fabricação De Papel,3851.24683370103,-46,97,143
9,Superior Completo,8321,Operadores De Máquinas De Fabricar Papel E Papelão,2842.0183260759823,50,404,354
9,Superior Completo,8331,Operadores De Máquinas Na Fabricação De Produtos De Papel E Papelão,1861.6890560758898,-25,225,250
9,Superior Completo,8332,Trabalhadores Artesanais De Produtos De Papel E Papelão,1673.723031204738,9,49,40
9,Superior Completo,8401,"Supervisores Da Fabricação De Alimentos, Bebidas E Fumo",5768.23261166284,-353,5969,6322
9,Superior Completo,8411,"Trabalhadores Da Indústria De Beneficiamento De Grãos, Cereais E Afins",2323.3516561296387,3,204,201
9,Superior Completo,8412,Trabalhadores No Beneficiamento Do Sal,1895.6072720614347,2,12,10
9,Superior Completo,8413,Trabalhadores Na Fabricação E Refino De Açúcar,3746.4489585293236,-67,202,269
9,Superior Completo,8414,Trabalhadores Na Fabricação E Conservação De Alimentos,2721.7416872515487,-43,1464,1507
9,Superior Completo,8415,Trabalhadores Na Pasteurização Do Leite E Na Fabricação De Laticínios  E Afins,2162.1377624262072,-7,1005,1012
9,Superior Completo,8416,"Trabalhadores Na Industrialização De Café, Cacau, Mate E De Produtos Afins",1650.472343742971,-8,43,51
9,Superior Completo,8417,"Trabalhadores Na Fabricação De Cachaça, Cerveja, Vinhos E Outras Bebidas",3225.9086925760694,-23,435,458
9,Superior Completo,8418,"Operadores De Equipamentos Na Fabricação De Pães, Massas Alimentícias, Doces, Chocolates E Achocolatados",2768.053202962164,-99,559,658
9,Superior Completo,8421,Cigarreiros E Beneficiadores De Fumo,2602.8054498392507,100,722,622
9,Superior Completo,8422,Charuteiros,2472.6649780273438,4,13,9
9,Superior Completo,8481,Trabalhadores Artesanais Na Conservação De Alimentos,1865.479840742087,-17,242,259
9,Superior Completo,8482,Trabalhadores Artesanais Na Pasteurização Do Leite E Na Fabricação De Laticínios E Afins,2166.2661546405993,-14,88,102
9,Superior Completo,8483,"Padeiros, Confeiteiros E Afins",2156.1572484381827,-85,4669,4754
9,Superior Completo,8484,Trabalhadores Na Degustação E Classificação De Grãos E Afins,2360.431735480157,53,1293,1240
9,Superior Completo,8485,Magarefes E Afins,2166.17958998683,-294,6352,6646
9,Superior Completo,8486,Trabalhadores Artesanais Na Indústria Do Fumo,1475.0264422579814,4,40,36
9,Superior Completo,8601,Supervisores Da Produção De Utilidades,6124.860275712112,-171,2535,2706
9,Superior Completo,8611,"Operadores De Instalações De Geração E Distribuição De Energia Elétrica, Hidráulica, Térmica Ou Nuclear",4642.944529372497,-27,537,564
9,Superior Completo,8612,Operadores De Instalações De Distribuição De Energia Elétrica,4715.124412514634,-51,148,199
9,Superior Completo,8621,Operadores De Máquinas A Vapor E Utilidades,4520.43536206707,-312,4649,4961
9,Superior Completo,8622,"Operadores De Instalações De Captação, Tratamento E Distribuição De Água",3072.453033238241,-176,643,819
9,Superior Completo,8623,Operadores De Instalações De Captação E Esgotos,2544.5972008447534,253,1703,1450
9,Superior Completo,8624,"Operadores De Instalações De Extração, Processamento, Envasamento E Distribuição De Gases",2681.6548165137615,22,120,98
9,Superior Completo,8625,Operadores De Instalações De Refrigeração E Ar-Condicionado,4559.887820935123,-7,142,149
9,Superior Completo,9101,"Supervisores Em Serviços De Reparação E Manutenção De Máquinas E Equipamentos Industriais, Comerciais E Residenciais",8312.631526112813,-41,5453,5494
9,Superior Completo,9102,Supervisores Em Serviços De Reparação E Manutenção Veicular,4526.437983966605,39,2080,2041
9,Superior Completo,9109,"Supervisores De Outros Trabalhadores De Serviços De Reparação, Conservação E Manutenção",5654.197772959553,-18,93,111
9,Superior Completo,9111,"Mecânicos De Manutenção De Bombas, Motores, Compressores E Equipamentos De Transmissão",3092.433487972098,40,493,453
9,Superior Completo,9112,Mecânicos De Manutenção E Instalação De Aparelhos De  Climatização E Refrigeração,2106.8500457064456,-3,861,864
9,Superior Completo,9113,Mecânicos De Manutenção De Máquinas Industriais,3963.8949477851334,-27,9203,9230
9,Superior Completo,9131,Mecânicos De Manutenção De Máquinas Pesadas E Equipamentos Agrícolas,3382.243229707875,127,1175,1048
9,Superior Completo,9141,Mecânicos De Manutenção Aeronáutica,3986.7125635133443,61,743,682
9,Superior Completo,9142,Mecânicos De Manutenção De Motores E Equipamentos Navais,5613.996328333805,-11,42,53
9,Superior Completo,9143,Mecânicos De Manutenção Metroferroviária,2321.592425707327,-45,103,148
9,Superior Completo,9144,Mecânicos De Manutenção De Veículos Automotores,2621.99567609402,423,5015,4592
9,Superior Completo,9151,Técnicos Em Manutenção E Reparação De Instrumentos De Medição E Precisão,2905.162429960792,31,590,559
9,Superior Completo,9152,Restauradores De Instrumentos Musicais,1589.0402597280652,5,17,12
9,Superior Completo,9153,Técnicos Em Manutenção E Reparação De Equipamentos Biomédicos,3494.197815163352,112,1156,1044
9,Superior Completo,9154,Reparadores De Equipamentos Fotográficos,3450.818115234375,0,8,8
9,Superior Completo,9191,Lubrificadores,2613.9279937751935,11,447,436
9,Superior Completo,9192,"Trabalhadores De Manutenção De Roçadeiras, Motoserras E Similares",2828.485976555416,-33,382,415
9,Superior Completo,9193,Mecânicos De Manutenção De Bicicletas E Equipamentos Esportivos E De Ginástica,1797.8841095084983,5,171,166
9,Superior Completo,9501,"Supervisores De Manutenção Eletroeletrônica Industrial, Comercial E Predial",6378.0241080358555,-211,3268,3479
9,Superior Completo,9502,Supervisores De Manutenção Eletroeletrônica Veicular,3340.2430914556226,-21,124,145
9,Superior Completo,9503,Supervisores De Manutenção Eletromecânica,7905.86548015396,-185,2425,2610
9,Superior Completo,9511,Eletricistas De Manutenção Eletroeletrônica,3546.226746034632,-207,6705,6912
9,Superior Completo,9513,Instaladores E Mantenedores De Sistemas Eletroeletrônicos De Segurança,1995.272797662819,339,4423,4084
9,Superior Completo,9531,"Eletricistas Eletrônicos De Manutenção Veicular (Aérea, Terrestre E Naval)",4039.5186779463706,8,748,740
9,Superior Completo,9541,"Instaladores E Mantenedores Eletromecânicos De Elevadores, Escadas E Portas Automáticas",2883.581164566428,-29,1670,1699
9,Superior Completo,9542,Reparadores De Aparelhos Eletrodomésticos,2383.5755781280327,-35,98,133
9,Superior Completo,9543,Reparadores De Equipamentos De Escritório,2141.643540837834,-35,172,207
9,Superior Completo,9911,Conservadores De Vias Permanentes (Trilhos),2872.231374083223,10,99,89
9,Superior Completo,9912,Mantenedores De Equipamentos De Parques De Diversões E Similares,1997.398535751715,1,21,20
9,Superior Completo,9913,Reparadores De Carrocerias De Veículos,1972.6865660900833,-3,384,387
9,Superior Completo,9921,Trabalhadores Elementares De Serviços De Manutenção Veicular,1732.2934872242145,15,431,416
9,Superior Completo,9922,Trabalhadores Operacionais De Conservação De Vias Permanentes (Exceto Trilhos),2301.690019814533,17,2565,2548
10,Mestrado,0000,Não especificado,3287.3536199796,-185,98,283
10,Mestrado,0101,Oficiais Generais Das Forças Armadas,6896.316015625,-3,1,4
10,Mestrado,0102,Oficiais Das Forças Armadas,56264,1,1,0
10,Mestrado,1111,Legisladores,15000,1,1,0
10,Mestrado,1112,Dirigentes Gerais Da Administração Pública,28297.520416259766,2,9,7
10,Mestrado,1114,Dirigentes Do Serviço Público,8600.46861210809,4,92,88
10,Mestrado,1115,Gestores Públicos,11108.463002490898,11,60,49
10,Mestrado,1130,"Dirigentes De Povos Indígenas, De Quilombolas E Caiçaras",8558,1,1,0
10,Mestrado,1141,Dirigentes De Partidos Políticos,7278.5,0,1,1
10,Mestrado,1142,Dirigentes E Administradores De Entidades Patronais E Dos Trabalhadores E De Outros Interesses Sócioeconômicos,13712.537841796875,4,8,4
10,Mestrado,1143,Dirigentes E Administradores De Entidades Religiosas,7549.6142578125,-4,4,8
10,Mestrado,1144,Dirigentes E Administradores De Organizações Da Sociedade Civil Sem Fins Lucrativos,12898.544588955965,-3,15,18
10,Mestrado,1210,Diretores Gerais,39131.12489207096,29,436,407
10,Mestrado,1221,"Diretores De Produção E Operações Em Empresa Agropecuária, Pesqueira , Aqüícola E Florestal",32562.144847869873,-6,3,9
10,Mestrado,1222,"Diretores De Produção E Operações Em Empresa Da Indústria Extrativa, Transformação E De Serviços De Utilidade Pública",48736.27223821272,-5,26,31
10,Mestrado,1223,Diretores De Operações De Obras Em Empresa De Construção,28879.0267609627,-5,13,18
10,Mestrado,1224,Diretores De Operações Em Empresa Do Comércio,36880.254565429685,1,18,17
10,Mestrado,1225,"Diretores De Serviços De Turismo, De Alojamento E De Alimentação",24816.787306722003,-2,14,16
10,Mestrado,1226,"Diretores De Operações De Serviços Em Empresa De Armazenamento, De Transporte E De Telecomunicação",32648.339586498118,-2,19,21
10,Mestrado,1227,Diretores De Operações De Serviços Em Instituição De Intermediação Financeira,34972.47231385309,-1,101,102
10,Mestrado,1231,Diretores Administrativos E Financeiros,34828.094616064605,-41,795,836
10,Mestrado,1232,Diretores De Recursos Humanos E Relações De Trabalho,36135.922364079095,-11,80,91
10,Mestrado,1233,Diretores De Comercialização E Marketing,41089.864806230005,19,447,428
10,Mestrado,1234,Diretores De Suprimentos E Afins,20677.346475629663,4,36,32
10,Mestrado,1236,Diretores De Tecnologia Da Informação,37107.77168118224,12,153,141
10,Mestrado,1237,Diretores De Pesquisa E Desenvolvimento,32740.86637167605,11,86,75
10,Mestrado,1238,Diretores De Manutenção,28362.236015768613,-4,15,19
10,Mestrado,1311,"Diretores E Gerentes De Operações Em Empresa De Serviços Pessoais, Sociais E Culturais",12869.13162928053,50,479,429
10,Mestrado,1312,"Gestores E Especialistas De Operações Em Empresas, Secretarias E Unidades De Serviços De Saúde",11329.006523485468,16,447,431
10,Mestrado,1313,Diretores E Gerentes De Instituição De Serviços Educacionais,10422.046447329602,-113,644,757
10,Mestrado,1411,"Gerentes De Produção E Operações Em Empresa Agropecuária, Pesqueira, Aqüícola E Florestal",12280.63436133642,19,76,57
10,Mestrado,1412,"Gerentes De Produção E Operações Em Empresa Da Indústria Extrativa, De Transformação E De Serviços De Utilidade Pública",17795.432081033254,-18,515,533
10,Mestrado,1413,Gerentes De Obras Em Empresa De Construção,13170.185,14,107,93
10,Mestrado,1414,Gerentes De Operações Comerciais E De Assistência Técnica,9820.469904663458,-52,145,197
10,Mestrado,1415,"Gerentes De Operações De Serviços Em Empresa De Turismo, De Alojamento E Alimentação",7743.919548604082,-8,83,91
10,Mestrado,1416,"Gerentes De Operações De Serviços Em Empresa De Transporte, De Comunicação E De Logística (Armazenagem E Distribuição)",15378.237924281966,-14,223,237
10,Mestrado,1417,Gerentes De Operações De Serviços Em Instituição De Intermediação Financeira,15799.443844698495,22,272,250
10,Mestrado,1418,Gerentes Operacionais Da Aviação Civil,14033.958740234375,11,12,1
10,Mestrado,1421,"Gerentes Administrativos, Financeiros, De Riscos E Afins",12959.756413944158,-23,2655,2678
10,Mestrado,1422,Gerentes De Recursos Humanos E De Relações Do Trabalho,11192.284050100086,-68,524,592
10,Mestrado,1423,"Gerentes De Comercialização, Marketing E Comunicação",13364.940996570238,1087,6617,5530
10,Mestrado,1424,Gerentes De Suprimentos E Afins,17609.56165418872,-5,213,218
10,Mestrado,1425,Gerentes De Tecnologia Da Informação,17063.821481091636,240,1859,1619
10,Mestrado,1426,Gerentes De Pesquisa E Desenvolvimento E Afins,18636.886188255045,-10,888,898
10,Mestrado,1427,Gerentes De Manutenção E Afins,12129.551092881075,51,404,353
10,Mestrado,2011,Profissionais Da Biotecnologia,7109.498041103354,23,85,62
10,Mestrado,2012,Profissionais Da Metrologia,7268.209677734374,2,8,6
10,Mestrado,2021,"Engenheiros De Controle E Automação, Engenheiros Mecatrônicos E Afins",9220.747175310042,26,100,74
10,Mestrado,2030,Pesquisadores Das Ciências Biológicas,6201.508676999312,30,180,150
10,Mestrado,2031,Pesquisadores Das Ciências Naturais E Exatas,7403.146035250662,144,640,496
10,Mestrado,2032,Pesquisadores De Engenharia E Tecnologia,12066.174384397344,36,756,720
10,Mestrado,2033,Pesquisadores Das Ciências Da Saúde,7511.872957911072,68,271,203
10,Mestrado,2034,Pesquisadores Das Ciências Da Agricultura,7644.241356519886,35,185,150
10,Mestrado,2035,Pesquisadores Das Ciências Sociais E Humanas,6474.326956860032,33,211,178
10,Mestrado,2041,Peritos Criminais E Judiciais,8838.563151041666,-1,1,2
10,Mestrado,2111,Profissionais Da Matemática,10907.812643651718,71,221,150
10,Mestrado,2112,Profissionais De Estatística E Afins,10230.698743998484,68,245,177
10,Mestrado,2122,Engenheiros Em Computação,14455.122727735055,535,1221,686
10,Mestrado,2123,Administradores De Tecnologia Da Informação,10746.341756605992,99,617,518
10,Mestrado,2124,Analistas De Tecnologia Da Informação,9351.251147463632,1266,6561,5295
10,Mestrado,2131,Físicos,10356.578939577133,-8,25,33
10,Mestrado,2132,Químicos,7017.9120310111075,-30,143,173
10,Mestrado,2133,Profissionais Das Ciências Atmosféricas E Espaciais E De Astronomia,6085.519052734375,19,47,28
10,Mestrado,2134,"Geólogos, Oceanógrafos, Geofísicos E Afins",9053.687722406783,6,393,387
10,Mestrado,2140,Engenheiros Ambientais E Afins,8706.283632294942,93,289,196
10,Mestrado,2141,Arquitetos E Urbanistas,10121.353461858764,25,160,135
10,Mestrado,2142,Engenheiros Civis E Afins,14955.83823033312,122,1025,903
10,Mestrado,2143,"Engenheiros Eletricistas, Eletrônicos E Afins",11358.322761321237,-24,541,565
10,Mestrado,2144,Engenheiros Mecânicos E Afins,12197.265366246022,113,726,613
10,Mestrado,2145,Engenheiros Químicos E Afins,14009.83301398917,-61,243,304
10,Mestrado,2146,"Engenheiros Metalurgistas, De Materiais E Afins",10938.823129629804,-8,88,96
10,Mestrado,2147,Engenheiros De Minas E Afins,15875.353428328459,120,265,145
10,Mestrado,2148,Engenheiros Agrimensores E Engenheiros Cartógrafos,9700.06521243649,-1,17,18
10,Mestrado,2149,"Engenheiros De Produção, Qualidade, Segurança E Afins",10172.845713411902,78,977,899
10,Mestrado,2151,Oficiais De Convés E Afins,10178.979199989117,8,56,48
10,Mestrado,2152,Oficiais De Máquinas Da Marinha Mercante,9892.204554966518,3,17,14
10,Mestrado,2153,Profissionais Da Pilotagem Aeronáutica,8544.115444164921,6,45,39
10,Mestrado,2211,Biólogos E Afins,5364.18756119945,-1,371,372
10,Mestrado,2212,Biomédicos,3446.2594195132224,-47,354,401
10,Mestrado,2221,Engenheiros Agrossilvipecuários,7394.65226336741,13,422,409
10,Mestrado,2222,Engenheiros De Alimentos E Afins,4899.802334074193,2,19,17
10,Mestrado,2232,Cirurgiões-Dentistas,6563.1105637278515,-1,333,334
10,Mestrado,2233,Veterinários E Zootecnistas,5911.338195449191,48,359,311
10,Mestrado,2234,Farmacêuticos,6632.135189458181,-124,1544,1668
10,Mestrado,2235,Enfermeiros E Afins,7230.858524727219,-207,2106,2313
10,Mestrado,2236,Fisioterapeutas,3549.50880193315,-53,842,895
10,Mestrado,2237,Nutricionistas,2955.1617136819023,40,534,494
10,Mestrado,2238,Fonoaudiólogos,2959.2538258950676,-24,239,263
10,Mestrado,2239,"Terapeutas Ocupacionais, Ortoptistas E Psicomotricistas",4057.4015741180956,-1,115,116
10,Mestrado,2241,Profissionais Da Educação Física,4176.091667319926,-60,364,424
10,Mestrado,2251,Médicos Clínicos,16843.466931750267,-219,1225,1444
10,Mestrado,2252,Médicos Em Especialidades Cirúrgicas,7824.368104901351,-45,89,134
10,Mestrado,2253,Médicos Em Medicina Diagnóstica E Terapêutica,7456.957030591206,3,30,27
10,Mestrado,2263,"Profissionais Das Terapias Criativas,Equoterápicas E Naturológicas",2667.7402235243057,-1,11,12
10,Mestrado,2311,Professores De Nível Superior Na Educação Infantil,4216.842641798472,-83,681,764
10,Mestrado,2312,Professores De Nível Superior Do Ensino Fundamental (Primeira A Quarta Séries),17240.74512393534,-136,3187,3323
10,Mestrado,2313,Professores De Nível Superior No Ensino Fundamental De Quinta A Oitava Série,3353.3886476194843,127,3386,3259
10,Mestrado,2321,Professores Do Ensino Médio,4078.7752230055003,308,5784,5476
10,Mestrado,2331,Professores Do Ensino Profissional,2857.697960828043,-275,596,871
10,Mestrado,2332,Instrutores De Ensino Profissional,5196.915974689799,391,1826,1435
10,Mestrado,2341,"Professores De Matemática, Estatística E Informática Do Ensino Superior",2782.00746212733,-379,1144,1523
10,Mestrado,2342,"Professores De Ciências Físicas, Químicas E Afins Do Ensino Superior",3859.1708157563903,-47,47,94
10,Mestrado,2343,"Professores De Arquitetura E Urbanismo, Engenharia, Geofísica E Geologia Do Ensino Superior",3171.273093958179,-814,1246,2060
10,Mestrado,2344,Professores De Ciências Biológicas E Da Saúde Do Ensino Superior,5049.099864105554,-333,3775,4108
10,Mestrado,2345,Professores Na Área De Formação Pedagógica Do Ensino Superior,6931.1756147985925,-3730,43489,47219
10,Mestrado,2346,Professores Nas Áreas De Língua E Literatura Do Ensino Superior,27395.57039225697,-185,1390,1575
10,Mestrado,2347,Professores De Ciências Humanas Do Ensino Superior,3331.253473226992,-1147,3362,4509
10,Mestrado,2348,"Professores De Ciências Econômicas, Administrativas E Contábeis Do Ensino Superior",3795.538559596543,-810,2143,2953
10,Mestrado,2349,Professores De Artes Do Ensino Superior,3325.9946053849367,-39,94,133
10,Mestrado,2392,Professores De Educação Especial,8081.868769408406,-20,115,135
10,Mestrado,2394,"Programadores, Avaliadores E Orientadores De Ensino",3354.1609186090363,861,9249,8388
10,Mestrado,2410,Advogados,10778.677814951956,127,1489,1362
10,Mestrado,2412,Procuradores E Advogados Públicos,8826.45472208659,5,11,6
10,Mestrado,2413,Tabeliães E Registradores,7397.5515173709755,-5,4,9
10,Mestrado,2424,Defensores Públicos E Procuradores Da Assistência Judiciária,8800.511291503906,1,3,2
10,Mestrado,2429,Profissionais Da Inteligência,7243.911085340712,1,11,10
10,Mestrado,2511,Profissionais Em Pesquisa E Análise Antropológica Sociológica,5513.538575432517,6,78,72
10,Mestrado,2512,Economistas,9772.526261104014,36,572,536
10,Mestrado,2513,Profissionais Em Pesquisa E Análise Geográfica,6627.456722178357,0,47,47
10,Mestrado,2514,Filósofos,7456.722564697266,0,2,2
10,Mestrado,2515,Psicólogos E Psicanalistas,2884.2587310846666,-122,774,896
10,Mestrado,2516,Assistentes Sociais E Economistas Domésticos,4456.612189499098,48,444,396
10,Mestrado,2521,Administradores,9160.21739404716,184,2776,2592
10,Mestrado,2522,Contadores E Afins,13843.495423515365,-117,887,1004
10,Mestrado,2523,Secretárias(Os) Executivas(Os) E Afins,7209.084152367285,21,581,560
10,Mestrado,2524,Profissionais De Recursos Humanos,6229.806159434971,10,728,718
10,Mestrado,2525,Profissionais De Administração Ecônomico-Financeira,10436.606645623744,70,854,784
10,Mestrado,2526,Profissionais Da Administração Dos Serviços De Segurança,12655.79032076322,17,41,24
10,Mestrado,2527,"Profissionais De Planejamento, Programação E Controles Logisticos",5521.539601797505,34,156,122
10,Mestrado,2531,Profissionais De Publicidade,10921.366963565266,22,495,473
10,Mestrado,2532,Profissionais De Comercializacão E Consultoria De Serviços Bancários,16788.78532537765,102,524,422
10,Mestrado,2533,"Corretores De Valores, Ativos Financeiros, Mercadorias E Derivativos",15406.592185058595,24,62,38
10,Mestrado,2534,Profissionais De Mídias Digitais E Afins,7485.543461914062,13,48,35
10,Mestrado,2543,Auditores Fiscais Do Trabalho,2798.1619873046875,3,4,1
10,Mestrado,2544,Fiscais De Tributos Estaduais E Municipais,5345.286627197265,0,9,9
10,Mestrado,2545,Profissionais Da Fiscalização De Atividades Urbanas,6281.281849254261,3,7,4
10,Mestrado,2611,Profissionais Do Jornalismo,6932.4078123430245,-25,603,628
10,Mestrado,2612,Profissionais Da Informação,6580.246380354428,88,511,423
10,Mestrado,2613,Arquivistas E Museólogos,4602.614823561448,26,70,44
10,Mestrado,2614,"Filólogos,Tradutores ,Intérpretes E Afins",6067.116262671433,-4,80,84
10,Mestrado,2615,Profissionais Da Escrita,6275.396947441848,-4,79,83
10,Mestrado,2616,Editores,6615.562473736291,9,85,76
10,Mestrado,2617,"Locutores, Comentaristas E Repórteres De Mídias Audiovisuais",4303.723624595775,-3,50,53
10,Mestrado,2618,Fotógrafos Profissionais,2927.014846801758,-4,4,8
10,Mestrado,2621,Produtores Artísticos E Culturais,4582.421968729702,-6,65,71
10,Mestrado,2622,Diretores De Espetáculos E Afins,20374.33365676153,3,20,17
10,Mestrado,2623,Cenógrafos,7819.33675023829,-13,7,20
10,Mestrado,2624,"Artistas Visuais,Desenhistas Industriais E Conservadores-Restauradores De Bens Culturais",6473.021732347466,124,558,434
10,Mestrado,2625,Atores,18592.6875,2,9,7
10,Mestrado,2626,"Músicos Compositores, Arranjadores, Regentes E Musicólogos",13468.56325813446,-3,23,26
10,Mestrado,2627,Músicos Intérpretes,3149.903663635254,18,36,18
10,Mestrado,2628,Artistas Da Dança (Exceto Dança Tradicional E Popular),3226.775258781084,-5,17,22
10,Mestrado,2629,Designer De Interiores De Nível Superior,5375.838297526042,2,4,2
10,Mestrado,2631,"Ministros De Culto, Missionários, Teólogos E Profissionais Assemelhados",4327.882520318855,-9,92,101
10,Mestrado,2711,Chefes De Cozinha E Afins,3983.140458195847,-1,32,33
10,Mestrado,3001,Técnicos Em Mecatrônica,5490.705373823273,-8,11,19
10,Mestrado,3003,Técnicos Em Eletromecânica,4178.71125793457,-2,11,13
10,Mestrado,3011,Técnicos De Laboratório Industrial,4171.302302746392,54,295,241
10,Mestrado,3012,Técnicos De Apoio À Bioengenharia,5234.016662597656,0,3,3
10,Mestrado,3111,Técnicos Químicos,4121.0584268305165,17,355,338
10,Mestrado,3112,"Técnicos De Produção De Indústrias Químicas, Petroquímicas, Refino De Petróleo, Gás E Afins",6413.986735026042,-2,2,4
10,Mestrado,3114,Técnicos Em Fabricação De Produtos Plásticos E De Borracha,4829.714015960693,6,12,6
10,Mestrado,3115,"Técnicos Em Controle Ambiental, Utilidades E Tratamento De Efluentes",6500.8262572942995,27,193,166
10,Mestrado,3116,Técnicos Têxteis,8149.838460286458,-2,1,3
10,Mestrado,3117,Coloristas,4352.3666585286455,1,3,2
10,Mestrado,3121,Técnicos Em Construção Civil (Edificações),4304.884205395023,18,160,142
10,Mestrado,3122,Técnicos Em Construção Civil (Obras De Infraestrutura),5358.554734790943,-8,22,30
10,Mestrado,3123,Técnicos Em Geomática,4859.401877591801,32,76,44
10,Mestrado,3131,Técnicos Em Eletricidade E Eletrotécnica,12651.338856302027,-21,96,117
10,Mestrado,3132,Técnicos Em Eletrônica,5127.718635515564,-43,91,134
10,Mestrado,3133,Técnicos Em Telecomunicações,3986.8500799948592,-8,40,48
10,Mestrado,3134,Técnicos Em Calibração E Instrumentação,5340.237623426649,-3,11,14
10,Mestrado,3135,Técnicos Em Fotônica,1779.4200439453125,-2,0,2
10,Mestrado,3141,"Técnicos Mecânicos Na Fabricação E Montagem De Máquinas, Sistemas E Instrumentos",4565.873424192994,-14,44,58
10,Mestrado,3142,Técnicos Mecânicos (Ferramentas),6724.109134928385,1,15,14
10,Mestrado,3143,Técnicos Em Mecânica Veicular,6169.683910392003,18,61,43
10,Mestrado,3144,"Técnicos Mecânicos Na Manutenção De Máquinas, Sistemas E Instrumentos",6514.290917833241,-4,33,37
10,Mestrado,3146,Técnicos Em Metalurgia (Estruturas Metálicas),6780.689615885417,-4,4,8
10,Mestrado,3147,Técnicos Em Siderurgia,12829.656994628906,4,9,5
10,Mestrado,3148,Especialistas Em Inspeções Industriais,6832.0106201171875,-1,4,5
10,Mestrado,3161,Técnicos Em Geologia,5467.8966778058275,6,21,15
10,Mestrado,3163,Técnicos Em Mineração,7613.546010335286,8,23,15
10,Mestrado,3171,Técnicos De Desenvolvimento De Sistemas E Aplicações,6690.886035175908,152,1451,1299
10,Mestrado,3172,Técnicos De Suporte E Monitoração Ao Usuário De Tecnologia Da Informação.,3646.641024233885,-15,180,195
10,Mestrado,3180,"Desenhistas Técnicos, Em Geral",4893.348114013672,-8,18,26
10,Mestrado,3181,Desenhistas Técnicos Da Construção Civil E Arquitetura,9108.582728692663,11,26,15
10,Mestrado,3182,Desenhistas Técnicos Da Mecânica,4477.792131696428,-4,5,9
10,Mestrado,3184,Desenhistas Técnicos De Produtos E Serviços Diversos,5113.316953801784,-11,26,37
10,Mestrado,3185,Desenhistas Projetistas De Construção Civil E Arquitetura,3695.932314990454,4,67,63
10,Mestrado,3186,Desenhistas Projetistas Da Mecânica,4675.737145641891,27,110,83
10,Mestrado,3187,Desenhistas Projetistas Da Eletrônica,4600.689176224109,0,34,34
10,Mestrado,3188,Desenhistas Projetistas E Modelistas De Produtos E Serviços Diversos,3380.2891551991906,3,38,35
10,Mestrado,3191,Técnicos Do Vestuário,5081.97998046875,-2,0,2
10,Mestrado,3192,Técnicos Do Mobiliário E Afins,2500,1,1,0
10,Mestrado,3201,Técnicos Em Biologia,3576.5852661132813,-1,12,13
10,Mestrado,3211,Técnicos Agrícolas,4196.17777958086,39,223,184
10,Mestrado,3212,Técnicos Florestais,4001.405755553583,16,108,92
10,Mestrado,3213,Técnicos Em Aqüicultura,3366.9600830078125,-1,1,2
10,Mestrado,3221,Tecnólogos E Técnicos Em Terapias Complementares E Estéticas,2270.0169292842984,-4,45,49
10,Mestrado,3222,Técnicos E Auxiliares De Enfermagem,2393.7981131755055,44,701,657
10,Mestrado,3223,Técnicos Em Óptica E Optometria,1360,1,1,0
10,Mestrado,3224,Técnicos De Odontologia,2131.310291273022,6,28,22
10,Mestrado,3231,Técnicos Em Pecuária,5797.033338758681,1,5,4
10,Mestrado,3241,Tecnólogos E Técnicos Em Métodos De Diagnósticos E Terapêutica,3731.338697631122,-16,48,64
10,Mestrado,3242,Técnicos De Laboratórios De Saúde E Bancos De Sangue,2543.657501902429,-28,246,274
10,Mestrado,3250,"Enólogos, Perfumistas E Aromistas",7634.381374782987,5,9,4
10,Mestrado,3251,Técnico Em Farmácia E Em Manipulação Farmacêutica,3120.746185538514,-5,60,65
10,Mestrado,3252,"Técnicos Em Produção, Conservação  E De Qualidade De Alimentos",3849.545680454799,-9,27,36
10,Mestrado,3253,Técnicos De Apoio À Biotecnologia,4108.469617403471,11,27,16
10,Mestrado,3281,Técnicos Em Necrópsia E Taxidermistas,2495,-1,0,1
10,Mestrado,3311,Professores De Nível Médio Na Educação Infantil,2578.6146626778564,-165,549,714
10,Mestrado,3312,Professores De Nível Médio No Ensino Fundamental,3106.8278206556433,-25,1529,1554
10,Mestrado,3313,Professores De Nível Médio No Ensino Profissionalizante,2482.631108440419,-22,273,295
10,Mestrado,3321,Professores Leigos No Ensino Fundamental,9073.583100766911,-79,130,209
10,Mestrado,3322,Professores Práticos No Ensino Profissionalizante,2077.342588356042,35,172,137
10,Mestrado,3331,Instrutores E Professores De Cursos Livres,5742.2712723188315,-60,1593,1653
10,Mestrado,3341,Inspetores De Alunos E Afins,1407.3567959890606,8,186,178
10,Mestrado,3411,"Pilotos De Aviação Comercial, Mecânicos De Vôo E Afins",5862.881038411459,-2,3,5
10,Mestrado,3412,"Técnicos Marítimos, Fluviários E Pescadores De Convés",5369.356628417969,-3,1,4
10,Mestrado,3413,Técnicos Marítimos E Fluviários De Máquinas,3859.36669921875,-1,1,2
10,Mestrado,3421,Especialistas Em Logística De Transportes,5467.997020130824,-19,139,158
10,Mestrado,3422,Despachantes Aduaneiros,3506.441650390625,0,3,3
10,Mestrado,3423,Técnicos Em Transportes Rodoviários,4648.569267604662,-8,19,27
10,Mestrado,3424,Técnicos Em Transportes Metroferroviários,8890.499658203125,-7,2,9
10,Mestrado,3425,Técnicos Em Transportes Aéreos,4930.064808033131,-5,14,19
10,Mestrado,3426,Técnicos Em Transportes Por Vias Navegáveis E Operações Portuárias,11061.877286044033,-1,11,12
10,Mestrado,3511,Técnicos Em Contabilidade,8461.559077247248,-9,44,53
10,Mestrado,3513,Técnicos Em Administração,5327.845065425405,-7,101,108
10,Mestrado,3514,Serventuários Da Justiça E Afins,3357.362776506847,15,93,78
10,Mestrado,3515,"Técnicos Em Secretariado, Taquígrafos E Estenotipistas",3020.250779893663,-1,58,59
10,Mestrado,3516,Técnicos Em Segurança Do Trabalho,7040.406506767648,22,200,178
10,Mestrado,3517,Técnicos De Seguros E Afins,7018.93681293456,9,102,93
10,Mestrado,3518,Agentes De Investigação E Identificação,8490.77001953125,0,1,1
10,Mestrado,3519,Técnicos Da Inteligência,7663.123779296875,3,7,4
10,Mestrado,3522,Agentes Da Saúde E Do Meio Ambiente,5125.081516816452,281,968,687
10,Mestrado,3523,Agentes  Fiscais Metrológicos E De Qualidade,3799.732255299886,13,43,30
10,Mestrado,3524,Profissionais De Direitos Autorais E De Avaliacão De Produtos Dos Meios De Comunicação,5283.33622418028,-2,6,8
10,Mestrado,3532,Técnicos Em Operações E Serviços Bancários,12341.010077702953,1,41,40
10,Mestrado,3541,Especialistas Em Promoção De Produtos E Vendas,6040.600229996033,342,1634,1292
10,Mestrado,3542,Compradores,7935.991998388372,-5,300,305
10,Mestrado,3543,Analistas De Comércio Exterior,5808.066422566329,9,106,97
10,Mestrado,3544,Leiloeiros E Avaliadores,3638.9530029296875,0,6,6
10,Mestrado,3545,Corretores De Seguros,16000,1,1,0
10,Mestrado,3546,Corretores De Imóveis E De Grãos,8073.399068196614,0,6,6
10,Mestrado,3547,Representantes Comerciais Autônomos,6101.337557705966,5,19,14
10,Mestrado,3548,Técnicos Em Serviços De Turismo E Organização De Eventos,3171.795697483872,-16,80,96
10,Mestrado,3711,Técnicos Em Biblioteconomia,3695.5198261594987,-8,15,23
10,Mestrado,3712,Técnicos Em Museologia E Afins,5367.76631303267,-3,4,7
10,Mestrado,3713,Técnicos Em Artes Gráficas,3596.061686197917,1,3,2
10,Mestrado,3714,Recreadores,1866.904111599359,4,67,63
10,Mestrado,3721,Captadores De Imagens Em Movimento,7911.617985801091,6,9,3
10,Mestrado,3722,Operadores De Rede De Teleprocessamento E Afins,2667.6201462745667,-11,32,43
10,Mestrado,3731,Técnicos De Operação De Registros Sonoro/Audiovisuais,4792.949556623187,-3,20,23
10,Mestrado,3732,Supervisores Operacionais E Técnicos Em Mídias Audiovisuais,6231.821934055638,-9,19,28
10,Mestrado,3741,Técnicos Em Áudio,3725.009573025174,-4,9,13
10,Mestrado,3742,Técnicos Em Cenografia,3456.2555135091147,-1,4,5
10,Mestrado,3743,Técnicos Em Operação De Aparelhos De Projeção,3577,-1,1,2
10,Mestrado,3744,"Técnicos Em Montagem, Edição E Finalização De Mídia Audiovisual",6200.6644002278645,8,35,27
10,Mestrado,3751,"Designers De Interiores, De Vitrines E Visual Merchandiser E Afins (Nível Médio)",4144.957508951823,-2,18,20
10,Mestrado,3762,Artistas De Circo (Circenses),1945,0,2,2
10,Mestrado,3763,"Apresentadores De Eventos, Programas E Espetáculos",13493.34710015191,0,5,5
10,Mestrado,3771,Atletas Profissionais,2711.1146883283345,3,7,4
10,Mestrado,3772,Árbitros Desportivos,4368.278747558594,4,7,3
10,Mestrado,3911,"Planejadores, Programadores E Controladores De Produção E Manutenção",14057.740615158371,41,491,450
10,Mestrado,3912,Técnicos De Controle Da Produção,4591.0537282772075,174,1250,1076
10,Mestrado,3951,Técnicos De Apoio Em Pesquisa E Desenvolvimento,7799.651706046219,173,624,451
10,Mestrado,4101,Supervisores Administrativos,7080.212593787053,117,1966,1849
10,Mestrado,4102,"Supervisores De Serviços Financeiros, De Câmbio E De Controle",7892.099103495505,-25,244,269
10,Mestrado,4110,"Agentes, Assistentes E Auxiliares Administrativos",3460.3304121214655,152,4520,4368
10,Mestrado,4121,Operadores De Equipamentos De Entrada E Transmissão De Dados,4750.868414223599,-16,24,40
10,Mestrado,4122,Contínuos,1677.9926182820248,-13,26,39
10,Mestrado,4131,Auxiliares De Contabilidade,2975.7111672515834,-9,341,350
10,Mestrado,4132,Escriturários De Serviços Bancários,4660.1576078303715,-105,275,380
10,Mestrado,4141,Almoxarifes E Armazenistas,1790.2460707625671,1,303,302
10,Mestrado,4142,Apontadores E Conferentes,3455.72317958629,-6,59,65
10,Mestrado,4151,"Auxiliares De Serviços De Documentação, Informação E Pesquisa",3443.375191752116,6,39,33
10,Mestrado,4152,"Trabalhadores Nos Serviços De Classificação E Entregas De Correspondências, Encomendas E Publicações",1876.8996496836344,0,7,7
10,Mestrado,4201,Supervisores De Atendimento Ao Público E De Pesquisa,4661.96916156039,-20,130,150
10,Mestrado,4211,Caixas E Bilheteiros (Exceto Caixa De Banco),1680.242338144951,9,244,235
10,Mestrado,4212,Coletadores De Apostas E De Jogos,1171.199986049107,-1,3,4
10,Mestrado,4213,Cobradores E Afins,5047.192524872225,0,46,46
10,Mestrado,4221,Recepcionistas,1766.940888662139,-54,397,451
10,Mestrado,4222,Operadores De Telefonia,1977.3819314014345,-21,30,51
10,Mestrado,4223,Operadores De Telemarketing E Afins,1888.6087158266114,-35,435,470
10,Mestrado,4231,Despachantes Documentalistas E Afins,2132.2124938964844,3,4,1
10,Mestrado,4241,Entrevistadores E Recenseadores,3133.629284892166,13,50,37
10,Mestrado,4242,Aplicadores De Provas E Afins,2015.4222208658855,5,9,4
10,Mestrado,5101,"Supervisores Dos Serviços De Transporte, Turismo, Hotelaria E Administração De Edifícios",5227.130448453388,1,27,26
10,Mestrado,5102,Supervisores De Lavanderia,4355.852818080357,-1,3,4
10,Mestrado,5103,"Supervisores Dos Serviços De Proteção, Segurança E Outros",5533.365754304109,-10,9,19
10,Mestrado,5111,Trabalhadores De Segurança E Atendimento Aos Usuários Nos Transportes,1827.4593864889705,4,11,7
10,Mestrado,5112,Fiscais E Cobradores Dos Transportes Coletivos,1618.260672548082,-6,14,20
10,Mestrado,5114,Guias De Turismo,2544.004619891827,-3,5,8
10,Mestrado,5121,Trabalhadores Dos Serviços Domésticos Em Geral,1459.6,1,3,2
10,Mestrado,5131,Mordomos E Governantas,4249.300048828125,2,2,0
10,Mestrado,5132,Cozinheiros,2089.772650017796,9,96,87
10,Mestrado,5133,"Camareiros, Roupeiros E Afins",2401.022784762912,0,14,14
10,Mestrado,5134,"Trabalhadores No Atendimento Em Estabelecimentos De Serviços De Alimentação, Bebidas E Hotelaria",2110.764295416105,-13,204,217
10,Mestrado,5135,Trabalhadores Auxiliares Nos Serviços De Alimentação,1476.5748241906879,16,95,79
10,Mestrado,5136,"Churrasqueiros, Pizzaiolos E Sushimen",1556.4824978298611,-1,8,9
10,Mestrado,5141,Trabalhadores Nos Serviços De Administração De Edifícios,2944.695006875431,-7,23,30
10,Mestrado,5142,"Trabalhadores Nos Serviços De Coleta De Resíduos, De Limpeza E Conservação De Áreas Públicas",1441.5842920240466,14,64,50
10,Mestrado,5143,Trabalhadores Nos  Serviços De Manutenção De Edificações,3408.04545890269,17,282,265
10,Mestrado,5151,Trabalhadores Em Serviços De Promoção E Apoio À Saúde,2718.4410045926534,33,75,42
10,Mestrado,5152,Auxiliares De Laboratório Da Saúde,1881.4549035173156,-11,137,148
10,Mestrado,5153,"Trabalhadores De Atenção, Defesa E Proteção A Pessoas Em Situação De Risco E Adolescentes Em Conflito Com A Lei",2798.32192372976,34,364,330
10,Mestrado,5161,Trabalhadores Nos Serviços De Embelezamento E Higiene,1375.2977973090276,1,6,5
10,Mestrado,5162,"Cuidadores De Crianças, Jovens, Adultos E Idosos",1550.6842549097578,8,49,41
10,Mestrado,5163,"Tintureiros, Lavadeiros E Afins, A Máquina",1426.7062377929688,3,13,10
10,Mestrado,5164,"Lavadores E Passadores De Roupa, A Mão",1377.7249755859375,0,1,1
10,Mestrado,5165,Trabalhadores Dos Serviços Funerários,1726.3320068359376,-1,2,3
10,Mestrado,5166,Trabalhadores Auxiliares Dos Serviços Funerários,2001.9599609375,-1,0,1
10,Mestrado,5168,Esotéricos E Paranormais,404.45001220703125,-1,0,1
10,Mestrado,5171,"Bombeiros, Salva-Vidas E Afins",2866.024042038691,-2,4,6
10,Mestrado,5172,"Policiais, Guardas-Civis Municipais E Agentes De Trânsito",1636.4993294927808,-2,5,7
10,Mestrado,5173,Vigilantes E Guardas De Segurança,3229.697753457349,-7,62,69
10,Mestrado,5174,"Porteiros, Vigias E Afins",1872.6725066203003,11,168,157
10,Mestrado,5191,Motociclistas E Ciclistas De Entregas Rápidas,1347.0737939294181,-5,24,29
10,Mestrado,5192,Trabalhadores Da Coleta E Seleção De Material Reciclável,1212,1,1,0
10,Mestrado,5193,"Trabalhadores De Serviços Veterinários, De Higiene E Estética De Animais Domésticos",1566.573650251116,2,15,13
10,Mestrado,5199,Outros Trabalhadores Dos Serviços,2336.094715542263,6,35,29
10,Mestrado,5201,Supervisores De Vendas E De Prestação De Serviços,7198.470471035122,-34,415,449
10,Mestrado,5211,Operadores Do Comércio Em Lojas E Mercados,2370.9346420836096,9,1796,1787
10,Mestrado,5241,Vendedores Em Domicílio,7023.2589249460325,2,96,94
10,Mestrado,5242,"Vendedores Em Bancas, Quiosques E Barracas",2400,0,1,1
10,Mestrado,5243,Vendedores Ambulantes,2832.344970703125,0,1,1
10,Mestrado,6110,Produtores Agropecuários Em Geral,1380.5,2,3,1
10,Mestrado,6120,Produtores Agrícolas Polivalentes,2293.1566569010415,1,2,1
10,Mestrado,6131,Produtores Em Pecuária De Animais De Grande Porte,3142.72998046875,-1,0,1
10,Mestrado,6132,Produtores Em Pecuária De Animais De Médio Porte,6270,-1,0,1
10,Mestrado,6133,Produtores Da Avicultura E Cunicultura,1500,0,1,1
10,Mestrado,6201,Supervisores Na Exploração Agropecuária,5478.210702600812,17,92,75
10,Mestrado,6210,Trabalhadores Agropecuários Em Geral,2316.1595067173484,39,81,42
10,Mestrado,6220,Trabalhadores De Apoio À Agricultura,4458.484694242958,19,98,79
10,Mestrado,6221,Trabalhadores Agrícolas Na Cultura De Gramíneas,1671.1420895156798,-7,20,27
10,Mestrado,6222,Trabalhadores Agrícolas Na Cultura De Plantas Fibrosas,7000,-1,0,1
10,Mestrado,6223,Trabalhadores Agrícolas Na Olericultura,1570,0,2,2
10,Mestrado,6224,Trabalhadores Agrícolas No Cultivo De Flores E Plantas Ornamentais,1681.6666666666667,1,3,2
10,Mestrado,6225,Trabalhadores Agrícolas Na Fruticultura,1395.7379355797402,18,65,47
10,Mestrado,6226,Trabalhadores Agrícolas Nas Culturas De Plantas Estimulantes,1550.800048828125,-1,4,5
10,Mestrado,6228,Trabalhadores Agrícolas Da Cultura De Especiarias E De Plantas Aromáticas E Medicinais,2648.25,-1,1,2
10,Mestrado,6230,Tratadores Polivalentes De Animais,2023.5131937662761,4,15,11
10,Mestrado,6231,Trabalhadores Na Pecuária De Animais De Grande Porte,1656.3978752367423,2,9,7
10,Mestrado,6232,Trabalhadores Na Pecuária De Animais De Médio Porte,2382.8,1,3,2
10,Mestrado,6233,Trabalhadores Na Avicultura E Cunicultura,2539.7285592215403,-3,10,13
10,Mestrado,6234,Trabalhadores Na Criação De Insetos E Animais Úteis,2300,1,1,0
10,Mestrado,6301,Supervisores Na Área Florestal E Aqüicultura,6936.235915016994,1,33,32
10,Mestrado,6310,Pescadores Polivalentes,4016.6666666666665,-1,1,2
10,Mestrado,6313,Criadores De Animais Aquáticos,2702.4214206271704,0,4,4
10,Mestrado,6320,Trabalhadores Florestais Polivalentes,2715.1333414713545,2,3,1
10,Mestrado,6321,Extrativistas E Reflorestadores De Espécies Produtoras De Madeira,2876.2002307214234,2,20,18
10,Mestrado,6326,Carvoejadores,1322,-1,0,1
10,Mestrado,6410,Trabalhadores Da Mecanização Agrícola,6685.596536294972,13,50,37
10,Mestrado,6420,Trabalhadores Da Mecanização Florestal,2901.7208251953125,3,8,5
10,Mestrado,6430,Trabalhadores Da Irrigação E Drenagem,3265.345001220703,1,4,3
10,Mestrado,7101,Supervisores Da Extração Mineral,13951.284471035693,24,47,23
10,Mestrado,7102,Supervisores Da Construção Civil,6695.508780758398,-3,52,55
10,Mestrado,7111,Trabalhadores Da Extração De Minerais Sólidos,2000,1,1,0
10,Mestrado,7112,Trabalhadores De Extração De Minerais Sólidos (Operadores De Máquinas),2117.800048828125,0,1,1
10,Mestrado,7113,Trabalhadores Da Extração De Minerais Líquidos E Gasosos,4180.117207845052,-4,2,6
10,Mestrado,7121,Trabalhadores De Beneficiamento De Minérios,1509.719970703125,-1,0,1
10,Mestrado,7122,Trabalhadores De Beneficiamento De Pedras Ornamentais,1668.6800048828125,1,3,2
10,Mestrado,7151,Trabalhadores Na Operação De Máquinas De Terraplenagem E Fundações,2141.574291576982,7,30,23
10,Mestrado,7152,Trabalhadores De Estruturas De Alvenaria,2015.3766928580499,-20,76,96
10,Mestrado,7153,Montadores De Estruturas De Concreto Armado,1791.0252705891926,6,20,14
10,Mestrado,7154,Trabalhadores Na Operação De Máquinas De Concreto Usinado E Afins,2174.22998046875,1,1,0
10,Mestrado,7155,"Trabalhadores De Montagem De Estruturas De Madeira, Metal E Compósitos Em Obras Civis",1808.4603453982563,-4,36,40
10,Mestrado,7156,Trabalhadores De Instalações Elétricas,2995.754732178937,-11,31,42
10,Mestrado,7157,Aplicadores De Materiais Isolantes,1849.6925048828125,1,4,3
10,Mestrado,7161,Revestidores De Concreto,2135.800048828125,1,1,0
10,Mestrado,7163,Vidraceiros (Revestimentos Rígidos),1432.0166829427083,1,2,1
10,Mestrado,7164,Gesseiros,2057.6799926757813,-2,1,3
10,Mestrado,7165,"Aplicadores De Revestimentos Cerâmicos, Pastilhas, Pedras E Madeiras",2147.800018310547,3,4,1
10,Mestrado,7166,Pintores De Obras E Revestidores De Interiores (Revestimentos Flexíveis),1831.1002351627794,1,22,21
10,Mestrado,7170,Ajudantes De Obras Civis,1610.8418986591748,10,141,131
10,Mestrado,7201,"Supervisores De Usinagem, Conformação E Tratamento De Metais",8771.024053664434,-1,8,9
10,Mestrado,7202,Supervisores Da Fabricação E Montagem Metalmecânica,12357.143494669595,-15,11,26
10,Mestrado,7211,Ferramenteiros E Afins,6477.559126420455,3,7,4
10,Mestrado,7212,Preparadores E Operadores De Máquinas-Ferramenta Convencionais,2038.8360207599142,-5,19,24
10,Mestrado,7213,Afiadores E Polidores De Metais,2027.2999877929688,2,3,1
10,Mestrado,7214,Operadores De Máquinas De Usinagem Cnc,2837.8983292049834,2,10,8
10,Mestrado,7221,Trabalhadores De Forjamento De Metais,2339.239990234375,-1,0,1
10,Mestrado,7222,Trabalhadores De Fundição De Metais Puros E De Ligas Metálicas,1745.2976025390624,-1,7,8
10,Mestrado,7223,Trabalhadores De Moldagem De Metais E De Ligas Metálicas,1600,0,1,1
10,Mestrado,7224,Trabalhadores De Trefilação E Estiramento De Metais Puros E Ligas Metálicas,1788.2000066583807,5,8,3
10,Mestrado,7231,Trabalhadores De Tratamento Térmico De Metais,26106.599975585938,3,3,0
10,Mestrado,7232,Trabalhadores De Tratamento De Superfícies De Metais E De Compósitos (Termoquímicos),7706.3499755859375,1,2,1
10,Mestrado,7233,"Trabalhadores Da Pintura De Equipamentos, Veículos, Estruturas Metálicas E De Compósitos",2354.4156426323784,0,8,8
10,Mestrado,7241,Encanadores E Instaladores De Tubulações,3241.386953202505,-3,19,22
10,Mestrado,7242,Trabalhadores De Traçagem E Montagem De Estruturas Metálicas E De Compósitos,1725.7135794503347,0,14,14
10,Mestrado,7243,Trabalhadores De Soldagem E Corte De Ligas Metálicas,2246.16333789908,5,44,39
10,Mestrado,7244,Trabalhadores De Caldeiraria E Serralheria,2338.5714305530896,4,36,32
10,Mestrado,7245,Operadores De Máquinas De Conformação De Metais,2062.0369873046875,0,5,5
10,Mestrado,7250,Ajustadores Mecânicos Polivalentes E Afins,1915.8282928466797,8,17,9
10,Mestrado,7251,"Montadores De Máquinas, Aparelhos E Acessórios Em Linhas De Montagem",1947.9237365722656,2,5,3
10,Mestrado,7252,Montadores De Máquinas Industriais,2570.3621564592636,0,7,7
10,Mestrado,7253,Montadores De Máquinas Pesadas E Equipamentos Agrícolas,2755.8900146484375,0,1,1
10,Mestrado,7255,Montadores De Veículos Automotores (Linha De Montagem),2445.931082589286,2,17,15
10,Mestrado,7256,Montadores De Sistemas E Estruturas De Aeronaves,3435.699951171875,1,1,0
10,Mestrado,7257,Instaladores De Equipamentos De Refrigeração E Ventilação,2151.0710205078126,0,5,5
10,Mestrado,7301,Supervisores De Montagens E Instalações Eletroeletrônicas,7700.68487713788,-7,15,22
10,Mestrado,7311,Montadores De Equipamentos Eletroeletrônicos,3032.8317815607243,-6,13,19
10,Mestrado,7312,Montadores De Aparelhos De Telecomunicações,1750.056640625,1,2,1
10,Mestrado,7313,Instaladores-Reparadores De  Linhas E Equipamentos De Telecomunicações,1642.260999891493,-3,5,8
10,Mestrado,7321,"Instaladores E Reparadores De Linhas E Cabos Elétricos, Telefônicos E De Comunicação De Dados",2503.2026413079993,4,53,49
10,Mestrado,7401,Supervisores Da Mecânica De Precisão E Instrumentos Musicais,6988.484802246094,-3,0,3
10,Mestrado,7411,Mecânicos De Instrumentos De Precisão,1858.7866617838542,-1,1,2
10,Mestrado,7502,"Supervisores De Vidraria, Cerâmica E Afins",7587.806640625,3,3,0
10,Mestrado,7511,Artesãos De Metais Preciosos E Semi-Preciosos,1658.8150024414063,-2,0,2
10,Mestrado,7522,Trabalhadores Da Transformação De Vidros Planos,3121.820068359375,-1,0,1
10,Mestrado,7523,Ceramistas (Preparação E Fabricação),5664.734995524089,-5,1,6
10,Mestrado,7524,Vidreiros E Ceramistas (Arte E Decoração),1300,1,1,0
10,Mestrado,7601,Supervisores Da Indústria Têxtil,1580.9749755859375,-2,1,3
10,Mestrado,7603,Supervisores Na Confecção Do Vestuário,9500,0,1,1
10,Mestrado,7604,Supervisores Na Confecção De Calçados,7377.246864720395,-1,9,10
10,Mestrado,7605,"Supervisores Da Confecção De Artefatos De Tecidos, Couros E Afins",2100,-1,0,1
10,Mestrado,7606,Supervisores Das Artes Gráficas,7865.6860388553505,-15,9,24
10,Mestrado,7612,Operadores Da Fiação,6139.68994140625,-2,0,2
10,Mestrado,7613,Operadores De Tear E Máquinas Similares,1395.6500244140625,-1,0,1
10,Mestrado,7614,"Trabalhadores De Acabamento, Tingimento E Estamparia Das Indústrias Têxteis",1805.4716796875,-1,3,4
10,Mestrado,7618,Inspetores E Revisores De Produção Têxtil,1760.4666748046875,1,2,1
10,Mestrado,7630,Profissionais Polivalentes Da Confecção De Roupas,2508.48907244647,0,8,8
10,Mestrado,7631,Trabalhadores Da Preparação Da Confecção De Roupas,1533.577500406901,-3,8,11
10,Mestrado,7632,Operadores De Máquinas Para Costura De Peças Do Vestuário,1294.118173340738,-3,22,25
10,Mestrado,7633,Operadores De Máquinas Para Bordado E Acabamento De Roupas,1495.8325093587239,-4,1,5
10,Mestrado,7640,Trabalhadores Polivalentes Da Confecção De Calçados,1287.3000081380208,-1,1,2
10,Mestrado,7641,Trabalhadores Da Preparação Da Confecção De Calçados,1269.4783426920574,1,4,3
10,Mestrado,7642,Operadores De Máquinas De Costurar E Montar Calçados,1656.0800083705358,1,4,3
10,Mestrado,7643,Trabalhadores De Acabamento De Calçados,1330,1,1,0
10,Mestrado,7650,Trabalhadores Polivalentes Da Confecção De Artefatos De Tecidos E Couros,1705,-1,0,1
10,Mestrado,7651,"Trabalhadores Da Preparação De Artefatos De Tecidos, Couros E Tapeçaria",1686.27001953125,-1,0,1
10,Mestrado,7652,"Trabalhadores Da Confecção De Artefatos De Tecidos, Couros E Sintéticos",2728,0,2,2
10,Mestrado,7654,Trabalhadores Do Acabamento De Artefatos De Tecidos E Couros,1705,1,1,0
10,Mestrado,7661,Trabalhadores Da Pré-Impressão Gráfica,8160.424376107006,-3,41,44
10,Mestrado,7662,Trabalhadores Da Impressão Gráfica,1979.9756240844727,1,6,5
10,Mestrado,7663,Trabalhadores Do Acabamento Gráfico,1797.2162322998047,-1,4,5
10,Mestrado,7664,Trabalhadores De Laboratório Fotográfico E Radiológico,4300.625061035156,-3,0,3
10,Mestrado,7701,"Supervisores Em Indústria De Madeira, Mobiliário E Da Carpintaria Veicular",3525.5625,1,3,2
10,Mestrado,7711,Marceneiros E Afins,2376.7317756204043,-1,8,9
10,Mestrado,7731,Operadores De Máquinas De Desdobramento Da Madeira,1361.6625061035156,0,2,2
10,Mestrado,7733,Operadores De Usinagem Convencional De Madeira,2900,1,1,0
10,Mestrado,7734,Operadores De Máquina De Usinar Madeira (Produção Em Série),1750.47998046875,-3,0,3
10,Mestrado,7741,Montadores De Móveis E Artefatos De Madeira,1615.7653238932292,-5,5,10
10,Mestrado,7751,Trabalhadores De Arte E  Do Acabamento Em Madeira Do Mobiliário,2500,-1,0,1
10,Mestrado,7771,Carpinteiros Navais,10500,1,1,0
10,Mestrado,7801,Supervisores De Trabalhadores De Embalagem E Etiquetagem,2699.0315223106973,3,8,5
10,Mestrado,7813,Operadores De Equipamentos Pilotados Remotamente,4315.977769639757,3,7,4
10,Mestrado,7817,Trabalhadores Subaquáticos,3768.1201171875,-1,0,1
10,Mestrado,7821,Operadores De Máquinas E Equipamentos De Elevação,1915.8879984537757,0,9,9
10,Mestrado,7822,Operadores De Equipamentos De Movimentação De Cargas,1619.0573323567708,-3,20,23
10,Mestrado,7823,Motoristas De Veículos De Pequeno E Médio Porte,1733.9979706971542,12,82,70
10,Mestrado,7824,"Motoristas De Ônibus Urbanos, Metropolitanos E Rodoviários",2226.220929092719,3,46,43
10,Mestrado,7825,Motoristas De Veículos De Cargas Em Geral,2107.8449722613946,24,142,118
10,Mestrado,7826,Operadores De Veículos Sobre Trilhos E Cabos Aéreos,3555.3300170898438,-5,2,7
10,Mestrado,7827,Trabalhadores Aquaviários,2300.1228271484374,1,8,7
10,Mestrado,7828,Condutores De Animais E De Veículos De Tração Animal E Pedais,1882.2650146484375,0,1,1
10,Mestrado,7831,Trabalhadores De Manobras De Transportes Sobre Trilhos,2968.81494140625,0,1,1
10,Mestrado,7832,Trabalhadores De Cargas E Descargas De Mercadorias,1408.6828865930147,2,82,80
10,Mestrado,7841,Trabalhadores De Embalagem E De Etiquetagem,1871.3909161234162,5,40,35
10,Mestrado,7842,Alimentadores De Linhas De Produção,1775.2178303019327,15,268,253
10,Mestrado,7911,Artesãos,1804.4300130208333,0,2,2
10,Mestrado,8101,"Supervisores De Produção Em Indústrias Químicas, Petroquímicas E Afins",8383.594358048349,-1,26,27
10,Mestrado,8102,Supervisores De Produção Em Indústrias De Transformação De Plásticos E Borrachas,6691.517606847427,-3,7,10
10,Mestrado,8103,"Supervisores De Produção Em Indústrias De Produtos Farmacêuticos, Cosméticos E Afins",7586.706497192383,-2,23,25
10,Mestrado,8110,"Operadores Polivalentes De Equipamentos Em Indústrias Químicas, Petroquímicas E Afins",6453.103747558594,-5,2,7
10,Mestrado,8111,Operadores De Equipamentos De Moagem E Mistura De Materiais (Tratamentos Químicos E Afins),5048.538472493489,-4,1,5
10,Mestrado,8112,Operadores De Calcinação E De Tratamentos Químicos De Materiais Radioativos,2717.875,1,2,1
10,Mestrado,8113,Operadores De Equipamentos De Filtragem E Separação,5180.938262939453,-19,15,34
10,Mestrado,8114,"Operadores De Equipamentos De Destilação, Evaporação E Reação",1934.5399658203125,0,3,3
10,Mestrado,8115,Operadores De Equipamentos De Produção E Refino De Petróleo E Gás,20000,-1,0,1
10,Mestrado,8116,Operadores De Equipamentos De Coqueificação,4262.003316243489,-2,2,4
10,Mestrado,8117,"Operadores De Instalações E Máquinas De Produtos Plásticos, De Borracha E Moldadores De Parafinas",2425.758652195786,0,7,7
10,Mestrado,8118,"Operadores De Máquinas E Instalações De Produtos Farmacêuticos, Cosméticos E Afins",1853.599520596591,-9,4,13
10,Mestrado,8131,"Operadores De Processos Das Indústrias De Transformação De Produtos Químicos, Petroquímicos E Afins",3942.62006992987,19,37,18
10,Mestrado,8181,Laboratoristas Industriais Auxiliares,2653.989647800353,8,196,188
10,Mestrado,8201,Supervisores De Produção Em Indústrias Siderúrgicas,8335.961502075195,-5,10,15
10,Mestrado,8202,Supervisores Na Fabricação De Materiais Para Construção (Vidros E Cerâmicas),11954.764953613281,-1,1,2
10,Mestrado,8211,Operadores De Instalações De Sinterização,4183.799987792969,4,4,0
10,Mestrado,8212,Operadores De Fornos De Primeira  Fusão E Aciaria,2640.982231987847,1,3,2
10,Mestrado,8213,Operadores De Equipamentos De Laminação,1617.1600341796875,1,1,0
10,Mestrado,8214,Operadores De Equipamentos De Acabamento De Chapas E Metais,3093.120574652778,4,21,17
10,Mestrado,8231,"Operadores Na Preparação De Massas Para Abrasivo, Vidro, Cerâmica, Porcelana E Materiais De Construção",1947.5599365234375,-2,0,2
10,Mestrado,8232,"Operadores De Equipamentos De Fabricação  E Beneficiamento De Cristais, Vidros, Cerâmicas, Porcelanas, Fibras De Vidro, Abrasivos E Afins",10484.703328450521,1,2,1
10,Mestrado,8233,Operadores De Instalações E Equipamentos De Fabricação De Materiais De Construção,1403.6000366210938,0,2,2
10,Mestrado,8281,Trabalhadores Da Fabricação De Cerâmica Estrutural Para Construção,1123.949951171875,-1,0,1
10,Mestrado,8301,Supervisores Da Fabricação De Celulose E Papel,12387.25460111178,5,9,4
10,Mestrado,8311,Preparadores De Pasta Para Fabricação De Papel,4471.22021484375,1,1,0
10,Mestrado,8321,Operadores De Máquinas De Fabricar Papel E Papelão,1618.4850158691406,-2,1,3
10,Mestrado,8331,Operadores De Máquinas Na Fabricação De Produtos De Papel E Papelão,1488,0,1,1
10,Mestrado,8401,"Supervisores Da Fabricação De Alimentos, Bebidas E Fumo",5189.773363952991,5,73,68
10,Mestrado,8413,Trabalhadores Na Fabricação E Refino De Açúcar,2657.8787231445313,-1,3,4
10,Mestrado,8414,Trabalhadores Na Fabricação E Conservação De Alimentos,1706.4295296223959,6,11,5
10,Mestrado,8415,Trabalhadores Na Pasteurização Do Leite E Na Fabricação De Laticínios  E Afins,1958.4378237516983,5,14,9
10,Mestrado,8416,"Trabalhadores Na Industrialização De Café, Cacau, Mate E De Produtos Afins",1100,-1,0,1
10,Mestrado,8417,"Trabalhadores Na Fabricação De Cachaça, Cerveja, Vinhos E Outras Bebidas",3807.2724812825522,-3,4,7
10,Mestrado,8418,"Operadores De Equipamentos Na Fabricação De Pães, Massas Alimentícias, Doces, Chocolates E Achocolatados",1811.2975056966145,-1,4,5
10,Mestrado,8421,Cigarreiros E Beneficiadores De Fumo,2512.2166646321616,1,4,3
10,Mestrado,8422,Charuteiros,1137.3333333333333,1,2,1
10,Mestrado,8481,Trabalhadores Artesanais Na Conservação De Alimentos,1809.538330078125,1,3,2
10,Mestrado,8483,"Padeiros, Confeiteiros E Afins",1620.1655019124348,-3,30,33
10,Mestrado,8484,Trabalhadores Na Degustação E Classificação De Grãos E Afins,2706.917691744291,-2,6,8
10,Mestrado,8485,Magarefes E Afins,1846.2707828723992,4,66,62
10,Mestrado,8486,Trabalhadores Artesanais Na Indústria Do Fumo,1269.4000244140625,-1,0,1
10,Mestrado,8601,Supervisores Da Produção De Utilidades,9458.779845883148,5,35,30
10,Mestrado,8611,"Operadores De Instalações De Geração E Distribuição De Energia Elétrica, Hidráulica, Térmica Ou Nuclear",6001.489990234375,-4,1,5
10,Mestrado,8612,Operadores De Instalações De Distribuição De Energia Elétrica,11243.01576450893,-7,0,7
10,Mestrado,8621,Operadores De Máquinas A Vapor E Utilidades,2833.7118620191304,1,37,36
10,Mestrado,8622,"Operadores De Instalações De Captação, Tratamento E Distribuição De Água",2602.191121419271,-10,4,14
10,Mestrado,8623,Operadores De Instalações De Captação E Esgotos,1973.1861688523065,-5,20,25
10,Mestrado,8624,"Operadores De Instalações De Extração, Processamento, Envasamento E Distribuição De Gases",4500,0,1,1
10,Mestrado,8625,Operadores De Instalações De Refrigeração E Ar-Condicionado,2819.409912109375,1,1,0
10,Mestrado,9101,"Supervisores Em Serviços De Reparação E Manutenção De Máquinas E Equipamentos Industriais, Comerciais E Residenciais",6942.019910852618,-15,41,56
10,Mestrado,9102,Supervisores Em Serviços De Reparação E Manutenção Veicular,6561.812268621271,-1,15,16
10,Mestrado,9109,"Supervisores De Outros Trabalhadores De Serviços De Reparação, Conservação E Manutenção",10829.125,0,1,1
10,Mestrado,9111,"Mecânicos De Manutenção De Bombas, Motores, Compressores E Equipamentos De Transmissão",5437.8175048828125,-2,3,5
10,Mestrado,9112,Mecânicos De Manutenção E Instalação De Aparelhos De  Climatização E Refrigeração,2495.597821916853,-4,5,9
10,Mestrado,9113,Mecânicos De Manutenção De Máquinas Industriais,4704.000553271191,-17,52,69
10,Mestrado,9131,Mecânicos De Manutenção De Máquinas Pesadas E Equipamentos Agrícolas,6034.333333333333,1,2,1
10,Mestrado,9141,Mecânicos De Manutenção Aeronáutica,3680.7899576822915,0,3,3
10,Mestrado,9143,Mecânicos De Manutenção Metroferroviária,9337.150146484375,0,1,1
10,Mestrado,9144,Mecânicos De Manutenção De Veículos Automotores,2220.0264007290084,7,35,28
10,Mestrado,9151,Técnicos Em Manutenção E Reparação De Instrumentos De Medição E Precisão,7139,1,2,1
10,Mestrado,9153,Técnicos Em Manutenção E Reparação De Equipamentos Biomédicos,3790.4195190429687,-6,7,13
10,Mestrado,9191,Lubrificadores,2434.505416870117,0,5,5
10,Mestrado,9192,"Trabalhadores De Manutenção De Roçadeiras, Motoserras E Similares",1401.0790904651988,1,6,5
10,Mestrado,9193,Mecânicos De Manutenção De Bicicletas E Equipamentos Esportivos E De Ginástica,1165,1,1,0
10,Mestrado,9501,"Supervisores De Manutenção Eletroeletrônica Industrial, Comercial E Predial",6160.201533290318,-4,25,29
10,Mestrado,9502,Supervisores De Manutenção Eletroeletrônica Veicular,9686.599609375,-1,0,1
10,Mestrado,9503,Supervisores De Manutenção Eletromecânica,10244.572720802436,7,33,26
10,Mestrado,9511,Eletricistas De Manutenção Eletroeletrônica,2886.75136866714,18,42,24
10,Mestrado,9513,Instaladores E Mantenedores De Sistemas Eletroeletrônicos De Segurança,1550.4297993009052,10,29,19
10,Mestrado,9531,"Eletricistas Eletrônicos De Manutenção Veicular (Aérea, Terrestre E Naval)",1369.3139770507812,-2,4,6
10,Mestrado,9541,"Instaladores E Mantenedores Eletromecânicos De Elevadores, Escadas E Portas Automáticas",4113.5818775318285,-31,8,39
10,Mestrado,9542,Reparadores De Aparelhos Eletrodomésticos,1469.5999755859375,0,1,1
10,Mestrado,9911,Conservadores De Vias Permanentes (Trilhos),2221.361962890625,-1,2,3
10,Mestrado,9913,Reparadores De Carrocerias De Veículos,2612.4667019314234,-1,4,5
10,Mestrado,9921,Trabalhadores Elementares De Serviços De Manutenção Veicular,1448.562784830729,3,7,4
10,Mestrado,9922,Trabalhadores Operacionais De Conservação De Vias Permanentes (Exceto Trilhos),2961.264610706676,-9,23,32
11,Doutorado,0000,Não especificado,3301.9965984405035,-56,44,100
11,Doutorado,0101,Oficiais Generais Das Forças Armadas,15225.2099609375,-1,0,1
11,Doutorado,1111,Legisladores,7320,1,1,0
11,Doutorado,1112,Dirigentes Gerais Da Administração Pública,14097.25,1,3,2
11,Doutorado,1114,Dirigentes Do Serviço Público,13101.673084174261,2,15,13
11,Doutorado,1115,Gestores Públicos,9697.027049345128,0,11,11
11,Doutorado,1142,Dirigentes E Administradores De Entidades Patronais E Dos Trabalhadores E De Outros Interesses Sócioeconômicos,6486.675048828125,0,1,1
11,Doutorado,1143,Dirigentes E Administradores De Entidades Religiosas,5864.72197265625,-3,1,4
11,Doutorado,1144,Dirigentes E Administradores De Organizações Da Sociedade Civil Sem Fins Lucrativos,135960.98504638672,2,7,5
11,Doutorado,1210,Diretores Gerais,31739.999907246085,-7,99,106
11,Doutorado,1221,"Diretores De Produção E Operações Em Empresa Agropecuária, Pesqueira , Aqüícola E Florestal",36457.347412109375,2,4,2
11,Doutorado,1222,"Diretores De Produção E Operações Em Empresa Da Indústria Extrativa, Transformação E De Serviços De Utilidade Pública",45966.986328125,0,2,2
11,Doutorado,1223,Diretores De Operações De Obras Em Empresa De Construção,37137.26513671875,2,3,1
11,Doutorado,1224,Diretores De Operações Em Empresa Do Comércio,37694.09002685547,2,5,3
11,Doutorado,1225,"Diretores De Serviços De Turismo, De Alojamento E De Alimentação",14122.019978841146,4,6,2
11,Doutorado,1226,"Diretores De Operações De Serviços Em Empresa De Armazenamento, De Transporte E De Telecomunicação",44885.61939561632,3,11,8
11,Doutorado,1227,Diretores De Operações De Serviços Em Instituição De Intermediação Financeira,39648.35592713648,1,16,15
11,Doutorado,1231,Diretores Administrativos E Financeiros,28678.356383646384,-15,169,184
11,Doutorado,1232,Diretores De Recursos Humanos E Relações De Trabalho,36239.5735812717,-4,12,16
11,Doutorado,1233,Diretores De Comercialização E Marketing,36186.05199725811,-12,57,69
11,Doutorado,1234,Diretores De Suprimentos E Afins,21170.833333333336,0,4,4
11,Doutorado,1236,Diretores De Tecnologia Da Informação,37113.093497440736,14,36,22
11,Doutorado,1237,Diretores De Pesquisa E Desenvolvimento,32725.709930889425,7,36,29
11,Doutorado,1238,Diretores De Manutenção,59000,0,1,1
11,Doutorado,1311,"Diretores E Gerentes De Operações Em Empresa De Serviços Pessoais, Sociais E Culturais",29319.05247362129,-6,126,132
11,Doutorado,1312,"Gestores E Especialistas De Operações Em Empresas, Secretarias E Unidades De Serviços De Saúde",9783.846095106337,5,197,192
11,Doutorado,1313,Diretores E Gerentes De Instituição De Serviços Educacionais,30432.890353710936,-52,222,274
11,Doutorado,1411,"Gerentes De Produção E Operações Em Empresa Agropecuária, Pesqueira, Aqüícola E Florestal",19823.273660685223,13,35,22
11,Doutorado,1412,"Gerentes De Produção E Operações Em Empresa Da Indústria Extrativa, De Transformação E De Serviços De Utilidade Pública",38794.93047214783,-6,94,100
11,Doutorado,1413,Gerentes De Obras Em Empresa De Construção,13530.545788574218,10,25,15
11,Doutorado,1414,Gerentes De Operações Comerciais E De Assistência Técnica,5767.640799420879,-17,54,71
11,Doutorado,1415,"Gerentes De Operações De Serviços Em Empresa De Turismo, De Alojamento E Alimentação",4202.376648072522,-4,25,29
11,Doutorado,1416,"Gerentes De Operações De Serviços Em Empresa De Transporte, De Comunicação E De Logística (Armazenagem E Distribuição)",10666.598842850693,-6,54,60
11,Doutorado,1417,Gerentes De Operações De Serviços Em Instituição De Intermediação Financeira,16290.489820959298,-18,45,63
11,Doutorado,1418,Gerentes Operacionais Da Aviação Civil,23751.6875,3,3,0
11,Doutorado,1421,"Gerentes Administrativos, Financeiros, De Riscos E Afins",9840.366050906621,-14,617,631
11,Doutorado,1422,Gerentes De Recursos Humanos E De Relações Do Trabalho,10462.839810180663,-35,73,108
11,Doutorado,1423,"Gerentes De Comercialização, Marketing E Comunicação",12628.597988873737,330,1655,1325
11,Doutorado,1424,Gerentes De Suprimentos E Afins,13585.367965977706,4,38,34
11,Doutorado,1425,Gerentes De Tecnologia Da Informação,14690.746257137516,238,718,480
11,Doutorado,1426,Gerentes De Pesquisa E Desenvolvimento E Afins,15174.675668061973,103,426,323
11,Doutorado,1427,Gerentes De Manutenção E Afins,9640.695991955774,11,67,56
11,Doutorado,2011,Profissionais Da Biotecnologia,8631.80693079519,30,79,49
11,Doutorado,2012,Profissionais Da Metrologia,7415.890239025297,2,8,6
11,Doutorado,2021,"Engenheiros De Controle E Automação, Engenheiros Mecatrônicos E Afins",10362.151245117188,-4,9,13
11,Doutorado,2030,Pesquisadores Das Ciências Biológicas,9038.947978553673,82,220,138
11,Doutorado,2031,Pesquisadores Das Ciências Naturais E Exatas,10259.772154809521,131,448,317
11,Doutorado,2032,Pesquisadores De Engenharia E Tecnologia,11009.448321333008,57,459,402
11,Doutorado,2033,Pesquisadores Das Ciências Da Saúde,9134.493612638602,81,300,219
11,Doutorado,2034,Pesquisadores Das Ciências Da Agricultura,7544.129291759078,-43,202,245
11,Doutorado,2035,Pesquisadores Das Ciências Sociais E Humanas,8268.324028749254,3,117,114
11,Doutorado,2111,Profissionais Da Matemática,9386.094992514605,20,79,59
11,Doutorado,2112,Profissionais De Estatística E Afins,10765.417920496091,27,105,78
11,Doutorado,2122,Engenheiros Em Computação,14856.294803054101,127,298,171
11,Doutorado,2123,Administradores De Tecnologia Da Informação,8817.409947165885,179,451,272
11,Doutorado,2124,Analistas De Tecnologia Da Informação,8338.116660500425,730,2752,2022
11,Doutorado,2131,Físicos,9854.081997612846,-1,25,26
11,Doutorado,2132,Químicos,7211.403943716222,22,126,104
11,Doutorado,2133,Profissionais Das Ciências Atmosféricas E Espaciais E De Astronomia,8238.870710100447,9,13,4
11,Doutorado,2134,"Geólogos, Oceanógrafos, Geofísicos E Afins",11364.082238365301,-6,107,113
11,Doutorado,2140,Engenheiros Ambientais E Afins,8589.130589754619,25,64,39
11,Doutorado,2141,Arquitetos E Urbanistas,9753.015593365646,11,40,29
11,Doutorado,2142,Engenheiros Civis E Afins,10797.573066985271,42,216,174
11,Doutorado,2143,"Engenheiros Eletricistas, Eletrônicos E Afins",12616.23234094822,7,84,77
11,Doutorado,2144,Engenheiros Mecânicos E Afins,12600.777419192324,11,129,118
11,Doutorado,2145,Engenheiros Químicos E Afins,10515.619477431193,-35,61,96
11,Doutorado,2146,"Engenheiros Metalurgistas, De Materiais E Afins",12163.693538665771,3,19,16
11,Doutorado,2147,Engenheiros De Minas E Afins,20666.849421011117,27,53,26
11,Doutorado,2148,Engenheiros Agrimensores E Engenheiros Cartógrafos,18784.7109375,-1,0,1
11,Doutorado,2149,"Engenheiros De Produção, Qualidade, Segurança E Afins",9906.381060886519,6,197,191
11,Doutorado,2151,Oficiais De Convés E Afins,11137.475002712672,-4,8,12
11,Doutorado,2152,Oficiais De Máquinas Da Marinha Mercante,3896.7900390625,1,1,0
11,Doutorado,2153,Profissionais Da Pilotagem Aeronáutica,11058.34490017361,6,24,18
11,Doutorado,2211,Biólogos E Afins,5472.154782145547,32,239,207
11,Doutorado,2212,Biomédicos,4422.134151914421,23,158,135
11,Doutorado,2221,Engenheiros Agrossilvipecuários,7663.251454743035,11,222,211
11,Doutorado,2222,Engenheiros De Alimentos E Afins,6284.572984483507,1,10,9
11,Doutorado,2232,Cirurgiões-Dentistas,5627.363791518223,1,115,114
11,Doutorado,2233,Veterinários E Zootecnistas,6270.016605816676,16,182,166
11,Doutorado,2234,Farmacêuticos,6855.551171906961,18,707,689
11,Doutorado,2235,Enfermeiros E Afins,4687.583406077972,-116,437,553
11,Doutorado,2236,Fisioterapeutas,2698.626796156718,-66,216,282
11,Doutorado,2237,Nutricionistas,3620.3714012308324,9,123,114
11,Doutorado,2238,Fonoaudiólogos,2987.5918370928084,-2,60,62
11,Doutorado,2239,"Terapeutas Ocupacionais, Ortoptistas E Psicomotricistas",3862.089267464571,-1,21,22
11,Doutorado,2241,Profissionais Da Educação Física,4249.537799521547,-15,71,86
11,Doutorado,2251,Médicos Clínicos,7900.485561738646,-471,1019,1490
11,Doutorado,2252,Médicos Em Especialidades Cirúrgicas,8151.598220879276,-48,113,161
11,Doutorado,2253,Médicos Em Medicina Diagnóstica E Terapêutica,12525.573325273404,-16,21,37
11,Doutorado,2261,Osteopatas E Quiropraxistas,12287.349609375,1,1,0
11,Doutorado,2311,Professores De Nível Superior Na Educação Infantil,7348.460722817791,-28,157,185
11,Doutorado,2312,Professores De Nível Superior Do Ensino Fundamental (Primeira A Quarta Séries),17954.597399781247,-100,725,825
11,Doutorado,2313,Professores De Nível Superior No Ensino Fundamental De Quinta A Oitava Série,3547.6867983416214,-45,707,752
11,Doutorado,2321,Professores Do Ensino Médio,3184.244453579448,157,1677,1520
11,Doutorado,2331,Professores Do Ensino Profissional,3899.2251689029267,-65,193,258
11,Doutorado,2332,Instrutores De Ensino Profissional,8590.753138418911,54,353,299
11,Doutorado,2341,"Professores De Matemática, Estatística E Informática Do Ensino Superior",6435.519909132659,-177,414,591
11,Doutorado,2342,"Professores De Ciências Físicas, Químicas E Afins Do Ensino Superior",4038.057676241141,-73,70,143
11,Doutorado,2343,"Professores De Arquitetura E Urbanismo, Engenharia, Geofísica E Geologia Do Ensino Superior",4575.44014076967,-462,530,992
11,Doutorado,2344,Professores De Ciências Biológicas E Da Saúde Do Ensino Superior,4559.531323705981,-457,2594,3051
11,Doutorado,2345,Professores Na Área De Formação Pedagógica Do Ensino Superior,5471.189823486171,-2443,18108,20551
11,Doutorado,2346,Professores Nas Áreas De Língua E Literatura Do Ensino Superior,32366.249242070364,-42,353,395
11,Doutorado,2347,Professores De Ciências Humanas Do Ensino Superior,5275.105495563492,-511,1380,1891
11,Doutorado,2348,"Professores De Ciências Econômicas, Administrativas E Contábeis Do Ensino Superior",6312.900158092195,-295,964,1259
11,Doutorado,2349,Professores De Artes Do Ensino Superior,4894.9144795730535,0,95,95
11,Doutorado,2392,Professores De Educação Especial,2625.9662237406887,11,44,33
11,Doutorado,2394,"Programadores, Avaliadores E Orientadores De Ensino",3606.5378814634796,226,2794,2568
11,Doutorado,2410,Advogados,10612.221177004878,24,333,309
11,Doutorado,2412,Procuradores E Advogados Públicos,8883.41253952753,-3,3,6
11,Doutorado,2413,Tabeliães E Registradores,1500.4000244140625,0,1,1
11,Doutorado,2424,Defensores Públicos E Procuradores Da Assistência Judiciária,7441.5,1,1,0
11,Doutorado,2429,Profissionais Da Inteligência,11744.884765625,-2,1,3
11,Doutorado,2511,Profissionais Em Pesquisa E Análise Antropológica Sociológica,6857.392735601528,8,29,21
11,Doutorado,2512,Economistas,10339.25609144748,14,132,118
11,Doutorado,2513,Profissionais Em Pesquisa E Análise Geográfica,9452.462604025135,1,12,11
11,Doutorado,2515,Psicólogos E Psicanalistas,5036.9269785306005,-24,148,172
11,Doutorado,2516,Assistentes Sociais E Economistas Domésticos,3722.2875475260416,-6,61,67
11,Doutorado,2521,Administradores,7930.66838233574,240,957,717
11,Doutorado,2522,Contadores E Afins,7087.7988626183405,-26,201,227
11,Doutorado,2523,Secretárias(Os) Executivas(Os) E Afins,6040.714364699375,16,177,161
11,Doutorado,2524,Profissionais De Recursos Humanos,4658.6489740050665,19,262,243
11,Doutorado,2525,Profissionais De Administração Ecônomico-Financeira,8342.375200747405,60,208,148
11,Doutorado,2526,Profissionais Da Administração Dos Serviços De Segurança,10227.241033380682,1,6,5
11,Doutorado,2527,"Profissionais De Planejamento, Programação E Controles Logisticos",5476.437571253712,16,45,29
11,Doutorado,2531,Profissionais De Publicidade,9319.932955170681,-2,119,121
11,Doutorado,2532,Profissionais De Comercializacão E Consultoria De Serviços Bancários,12564.103910712785,-85,127,212
11,Doutorado,2533,"Corretores De Valores, Ativos Financeiros, Mercadorias E Derivativos",11370.200276692709,-1,4,5
11,Doutorado,2534,Profissionais De Mídias Digitais E Afins,3426.5184936523438,0,6,6
11,Doutorado,2543,Auditores Fiscais Do Trabalho,0,-1,0,1
11,Doutorado,2544,Fiscais De Tributos Estaduais E Municipais,10807.846761067709,1,3,2
11,Doutorado,2545,Profissionais Da Fiscalização De Atividades Urbanas,3634.4100341796875,-1,1,2
11,Doutorado,2611,Profissionais Do Jornalismo,7380.161039037331,10,142,132
11,Doutorado,2612,Profissionais Da Informação,6789.994751498326,52,229,177
11,Doutorado,2613,Arquivistas E Museólogos,7734.779850260416,4,10,6
11,Doutorado,2614,"Filólogos,Tradutores ,Intérpretes E Afins",5138.75448167589,0,21,21
11,Doutorado,2615,Profissionais Da Escrita,6459.51236574793,0,30,30
11,Doutorado,2616,Editores,6414.742381701596,8,27,19
11,Doutorado,2617,"Locutores, Comentaristas E Repórteres De Mídias Audiovisuais",2579.6539416593664,1,17,16
11,Doutorado,2618,Fotógrafos Profissionais,5980.998372395834,0,2,2
11,Doutorado,2621,Produtores Artísticos E Culturais,5056.6704355875645,0,12,12
11,Doutorado,2622,Diretores De Espetáculos E Afins,43894.61748976935,2,11,9
11,Doutorado,2623,Cenógrafos,12221.365364583333,3,9,6
11,Doutorado,2624,"Artistas Visuais,Desenhistas Industriais E Conservadores-Restauradores De Bens Culturais",6386.4975769736575,1,102,101
11,Doutorado,2625,Atores,40689.333333333336,1,2,1
11,Doutorado,2626,"Músicos Compositores, Arranjadores, Regentes E Musicólogos",3423.4151893898293,2,7,5
11,Doutorado,2627,Músicos Intérpretes,8264.794921875,-2,3,5
11,Doutorado,2628,Artistas Da Dança (Exceto Dança Tradicional E Popular),6672.9375,-2,1,3
11,Doutorado,2629,Designer De Interiores De Nível Superior,2790,-1,0,1
11,Doutorado,2631,"Ministros De Culto, Missionários, Teólogos E Profissionais Assemelhados",4484.354769607405,-9,29,38
11,Doutorado,2711,Chefes De Cozinha E Afins,2629.216502719455,-8,4,12
11,Doutorado,3001,Técnicos Em Mecatrônica,3225.1834528996396,6,10,4
11,Doutorado,3003,Técnicos Em Eletromecânica,3808.086683485243,7,8,1
11,Doutorado,3011,Técnicos De Laboratório Industrial,5091.992475083749,33,111,78
11,Doutorado,3012,Técnicos De Apoio À Bioengenharia,4000,1,1,0
11,Doutorado,3111,Técnicos Químicos,6664.428282569075,27,171,144
11,Doutorado,3112,"Técnicos De Produção De Indústrias Químicas, Petroquímicas, Refino De Petróleo, Gás E Afins",1795.1444227430557,-3,3,6
11,Doutorado,3113,"Técnicos Em Materiais, Produtos Cerâmicos E Vidros",16633.400390625,1,1,0
11,Doutorado,3114,Técnicos Em Fabricação De Produtos Plásticos E De Borracha,1995.9162292480469,-1,2,3
11,Doutorado,3115,"Técnicos Em Controle Ambiental, Utilidades E Tratamento De Efluentes",5735.2193256452965,16,44,28
11,Doutorado,3116,Técnicos Têxteis,5700,1,1,0
11,Doutorado,3117,Coloristas,1241,-1,0,1
11,Doutorado,3121,Técnicos Em Construção Civil (Edificações),3938.236888885498,-10,27,37
11,Doutorado,3122,Técnicos Em Construção Civil (Obras De Infraestrutura),6061.25,1,2,1
11,Doutorado,3123,Técnicos Em Geomática,5037.378446901,5,16,11
11,Doutorado,3131,Técnicos Em Eletricidade E Eletrotécnica,3631.0367564954263,-37,30,67
11,Doutorado,3132,Técnicos Em Eletrônica,3278.061393121458,-33,64,97
11,Doutorado,3133,Técnicos Em Telecomunicações,9657.776774479793,-13,11,24
11,Doutorado,3134,Técnicos Em Calibração E Instrumentação,6732.37044813368,-1,6,7
11,Doutorado,3135,Técnicos Em Fotônica,2613.3524475097656,-4,0,4
11,Doutorado,3141,"Técnicos Mecânicos Na Fabricação E Montagem De Máquinas, Sistemas E Instrumentos",2850.8140234374996,-7,16,23
11,Doutorado,3142,Técnicos Mecânicos (Ferramentas),7494.831111653645,7,15,8
11,Doutorado,3143,Técnicos Em Mecânica Veicular,5013.447991071429,-4,19,23
11,Doutorado,3144,"Técnicos Mecânicos Na Manutenção De Máquinas, Sistemas E Instrumentos",5117.681813779085,7,21,14
11,Doutorado,3147,Técnicos Em Siderurgia,9885,-1,0,1
11,Doutorado,3148,Especialistas Em Inspeções Industriais,6852.5751953125,2,2,0
11,Doutorado,3161,Técnicos Em Geologia,5142.82998046875,-1,2,3
11,Doutorado,3163,Técnicos Em Mineração,12191.26416015625,6,7,1
11,Doutorado,3171,Técnicos De Desenvolvimento De Sistemas E Aplicações,6834.867514799832,-24,355,379
11,Doutorado,3172,Técnicos De Suporte E Monitoração Ao Usuário De Tecnologia Da Informação.,3119.650139887646,91,222,131
11,Doutorado,3180,"Desenhistas Técnicos, Em Geral",3838.488905164931,-3,2,5
11,Doutorado,3181,Desenhistas Técnicos Da Construção Civil E Arquitetura,3098.8500061035156,4,5,1
11,Doutorado,3184,Desenhistas Técnicos De Produtos E Serviços Diversos,4755.75009765625,-2,2,4
11,Doutorado,3185,Desenhistas Projetistas De Construção Civil E Arquitetura,3908.8183929443358,2,10,8
11,Doutorado,3186,Desenhistas Projetistas Da Mecânica,5135.931257659313,0,10,10
11,Doutorado,3187,Desenhistas Projetistas Da Eletrônica,6131.788049942408,-2,7,9
11,Doutorado,3188,Desenhistas Projetistas E Modelistas De Produtos E Serviços Diversos,4244.979151407877,3,5,2
11,Doutorado,3201,Técnicos Em Biologia,2667.9111750676084,0,7,7
11,Doutorado,3211,Técnicos Agrícolas,5843.538289201626,11,83,72
11,Doutorado,3212,Técnicos Florestais,5106.37360864756,-4,23,27
11,Doutorado,3213,Técnicos Em Aqüicultura,3557.530029296875,-2,0,2
11,Doutorado,3221,Tecnólogos E Técnicos Em Terapias Complementares E Estéticas,1846.6727495143023,-3,12,15
11,Doutorado,3222,Técnicos E Auxiliares De Enfermagem,2720.8321262182144,-100,142,242
11,Doutorado,3223,Técnicos Em Óptica E Optometria,2289.5,-2,1,3
11,Doutorado,3224,Técnicos De Odontologia,2560.8770825582837,-3,13,16
11,Doutorado,3226,Técnicos De Imobilizações Ortopédicas,2794.219970703125,-1,1,2
11,Doutorado,3231,Técnicos Em Pecuária,6037.981174045139,1,5,4
11,Doutorado,3241,Tecnólogos E Técnicos Em Métodos De Diagnósticos E Terapêutica,1495.1643578115136,-12,13,25
11,Doutorado,3242,Técnicos De Laboratórios De Saúde E Bancos De Sangue,4663.447890173733,-9,105,114
11,Doutorado,3250,"Enólogos, Perfumistas E Aromistas",5968.333333333333,1,3,2
11,Doutorado,3251,Técnico Em Farmácia E Em Manipulação Farmacêutica,2489.6580159638183,-19,11,30
11,Doutorado,3252,"Técnicos Em Produção, Conservação  E De Qualidade De Alimentos",4506.075663865215,1,16,15
11,Doutorado,3253,Técnicos De Apoio À Biotecnologia,5214.787400987413,13,21,8
11,Doutorado,3281,Técnicos Em Necrópsia E Taxidermistas,4892.5400390625,1,1,0
11,Doutorado,3311,Professores De Nível Médio Na Educação Infantil,2058.125915927468,7,142,135
11,Doutorado,3312,Professores De Nível Médio No Ensino Fundamental,3936.0196938701765,55,405,350
11,Doutorado,3313,Professores De Nível Médio No Ensino Profissionalizante,2636.308546746031,26,107,81
11,Doutorado,3321,Professores Leigos No Ensino Fundamental,34399.624634561915,-72,53,125
11,Doutorado,3322,Professores Práticos No Ensino Profissionalizante,2472.0185077164365,0,44,44
11,Doutorado,3331,Instrutores E Professores De Cursos Livres,26276.29681775642,-43,409,452
11,Doutorado,3341,Inspetores De Alunos E Afins,1454.4248814769453,15,58,43
11,Doutorado,3411,"Pilotos De Aviação Comercial, Mecânicos De Vôo E Afins",11874.51953125,-1,0,1
11,Doutorado,3412,"Técnicos Marítimos, Fluviários E Pescadores De Convés",1559.6099853515625,1,2,1
11,Doutorado,3421,Especialistas Em Logística De Transportes,3760.1837238168023,17,84,67
11,Doutorado,3422,Despachantes Aduaneiros,4043.8333333333335,0,2,2
11,Doutorado,3423,Técnicos Em Transportes Rodoviários,4148.976655470723,0,11,11
11,Doutorado,3424,Técnicos Em Transportes Metroferroviários,2729.127429962158,-2,1,3
11,Doutorado,3425,Técnicos Em Transportes Aéreos,4503.0139322634095,-12,34,46
11,Doutorado,3426,Técnicos Em Transportes Por Vias Navegáveis E Operações Portuárias,10748.425130208334,0,3,3
11,Doutorado,3511,Técnicos Em Contabilidade,5743.605388047959,7,20,13
11,Doutorado,3513,Técnicos Em Administração,7125.113683926857,12,48,36
11,Doutorado,3514,Serventuários Da Justiça E Afins,3664.3336232789534,3,29,26
11,Doutorado,3515,"Técnicos Em Secretariado, Taquígrafos E Estenotipistas",3798.2275009155273,-4,6,10
11,Doutorado,3516,Técnicos Em Segurança Do Trabalho,5572.202687467083,3,91,88
11,Doutorado,3517,Técnicos De Seguros E Afins,5756.06131439209,1,25,24
11,Doutorado,3522,Agentes Da Saúde E Do Meio Ambiente,5522.0739944909255,58,242,184
11,Doutorado,3523,Agentes  Fiscais Metrológicos E De Qualidade,3449.288568405878,-3,9,12
11,Doutorado,3524,Profissionais De Direitos Autorais E De Avaliacão De Produtos Dos Meios De Comunicação,4633.9850507463725,2,5,3
11,Doutorado,3532,Técnicos Em Operações E Serviços Bancários,11667.727916541466,1,10,9
11,Doutorado,3541,Especialistas Em Promoção De Produtos E Vendas,5597.879537566428,51,509,458
11,Doutorado,3542,Compradores,7709.540393647694,15,102,87
11,Doutorado,3543,Analistas De Comércio Exterior,7558.71390109592,-2,17,19
11,Doutorado,3544,Leiloeiros E Avaliadores,5336.948745727539,1,3,2
11,Doutorado,3545,Corretores De Seguros,7785.080078125,2,2,0
11,Doutorado,3546,Corretores De Imóveis E De Grãos,6378.615005493164,0,2,2
11,Doutorado,3547,Representantes Comerciais Autônomos,5723.562677556818,-3,4,7
11,Doutorado,3548,Técnicos Em Serviços De Turismo E Organização De Eventos,3656.5086038154463,-6,15,21
11,Doutorado,3711,Técnicos Em Biblioteconomia,3721.883758544922,-2,3,5
11,Doutorado,3713,Técnicos Em Artes Gráficas,5599.5,0,2,2
11,Doutorado,3714,Recreadores,2393.28655066857,0,13,13
11,Doutorado,3721,Captadores De Imagens Em Movimento,2120.885009765625,0,1,1
11,Doutorado,3722,Operadores De Rede De Teleprocessamento E Afins,1879.1799723307292,-2,2,4
11,Doutorado,3731,Técnicos De Operação De Registros Sonoro/Audiovisuais,3546.4074139065215,0,9,9
11,Doutorado,3732,Supervisores Operacionais E Técnicos Em Mídias Audiovisuais,5900.438340928819,-2,6,8
11,Doutorado,3741,Técnicos Em Áudio,8530.5,0,1,1
11,Doutorado,3743,Técnicos Em Operação De Aparelhos De Projeção,1947.56005859375,-1,0,1
11,Doutorado,3744,"Técnicos Em Montagem, Edição E Finalização De Mídia Audiovisual",3721.6380095305267,6,15,9
11,Doutorado,3751,"Designers De Interiores, De Vitrines E Visual Merchandiser E Afins (Nível Médio)",5047.757758246528,-1,3,4
11,Doutorado,3762,Artistas De Circo (Circenses),1700,-1,0,1
11,Doutorado,3763,"Apresentadores De Eventos, Programas E Espetáculos",9781.90000406901,2,3,1
11,Doutorado,3771,Atletas Profissionais,600,-1,0,1
11,Doutorado,3911,"Planejadores, Programadores E Controladores De Produção E Manutenção",6164.52068544277,-10,147,157
11,Doutorado,3912,Técnicos De Controle Da Produção,4136.117261716998,77,426,349
11,Doutorado,3951,Técnicos De Apoio Em Pesquisa E Desenvolvimento,8249.739337119736,94,319,225
11,Doutorado,4101,Supervisores Administrativos,7368.217619306271,16,590,574
11,Doutorado,4102,"Supervisores De Serviços Financeiros, De Câmbio E De Controle",8382.465554208478,-7,59,66
11,Doutorado,4110,"Agentes, Assistentes E Auxiliares Administrativos",2769.838846093424,-229,1302,1531
11,Doutorado,4121,Operadores De Equipamentos De Entrada E Transmissão De Dados,7081.0109860346865,-4,20,24
11,Doutorado,4122,Contínuos,1376.1338454026443,-16,5,21
11,Doutorado,4131,Auxiliares De Contabilidade,2724.5340056910622,-33,89,122
11,Doutorado,4132,Escriturários De Serviços Bancários,3691.8552488185906,-32,62,94
11,Doutorado,4141,Almoxarifes E Armazenistas,2281.350265553639,-19,241,260
11,Doutorado,4142,Apontadores E Conferentes,2719.7070292955564,-11,31,42
11,Doutorado,4151,"Auxiliares De Serviços De Documentação, Informação E Pesquisa",3714.294539388021,0,12,12
11,Doutorado,4152,"Trabalhadores Nos Serviços De Classificação E Entregas De Correspondências, Encomendas E Publicações",2721.550550672743,-1,4,5
11,Doutorado,4201,Supervisores De Atendimento Ao Público E De Pesquisa,5166.284538224717,-11,51,62
11,Doutorado,4211,Caixas E Bilheteiros (Exceto Caixa De Banco),1474.2984144333805,-59,74,133
11,Doutorado,4212,Coletadores De Apostas E De Jogos,1159.0599928635818,-5,4,9
11,Doutorado,4213,Cobradores E Afins,4063.1623179796006,-9,10,19
11,Doutorado,4221,Recepcionistas,1749.2027571309166,-56,103,159
11,Doutorado,4222,Operadores De Telefonia,2245.9998020925923,9,94,85
11,Doutorado,4223,Operadores De Telemarketing E Afins,1928.6396009081243,211,655,444
11,Doutorado,4231,Despachantes Documentalistas E Afins,1446.649980545044,-1,1,2
11,Doutorado,4241,Entrevistadores E Recenseadores,5257.056115044487,-12,4,16
11,Doutorado,4242,Aplicadores De Provas E Afins,3661.0628836495534,3,5,2
11,Doutorado,5101,"Supervisores Dos Serviços De Transporte, Turismo, Hotelaria E Administração De Edifícios",3751.5446695963547,-13,3,16
11,Doutorado,5102,Supervisores De Lavanderia,3865.27001953125,1,1,0
11,Doutorado,5103,"Supervisores Dos Serviços De Proteção, Segurança E Outros",4985.552756569602,-1,5,6
11,Doutorado,5111,Trabalhadores De Segurança E Atendimento Aos Usuários Nos Transportes,1944.1444539388021,-8,5,13
11,Doutorado,5112,Fiscais E Cobradores Dos Transportes Coletivos,1555.5266971588135,-4,16,20
11,Doutorado,5114,Guias De Turismo,6564.60009765625,-1,0,1
11,Doutorado,5121,Trabalhadores Dos Serviços Domésticos Em Geral,1283.5,2,3,1
11,Doutorado,5131,Mordomos E Governantas,3738.6666666666665,0,3,3
11,Doutorado,5132,Cozinheiros,1455.8737691243489,-29,26,55
11,Doutorado,5133,"Camareiros, Roupeiros E Afins",1247.9957917865954,3,11,8
11,Doutorado,5134,"Trabalhadores No Atendimento Em Estabelecimentos De Serviços De Alimentação, Bebidas E Hotelaria",1488.9982440988172,-41,89,130
11,Doutorado,5135,Trabalhadores Auxiliares Nos Serviços De Alimentação,1451.7454018106266,-10,46,56
11,Doutorado,5136,"Churrasqueiros, Pizzaiolos E Sushimen",1530.4672139485676,-5,3,8
11,Doutorado,5141,Trabalhadores Nos Serviços De Administração De Edifícios,2948.4549948798285,-7,23,30
11,Doutorado,5142,"Trabalhadores Nos Serviços De Coleta De Resíduos, De Limpeza E Conservação De Áreas Públicas",1220.8128839168908,40,110,70
11,Doutorado,5143,Trabalhadores Nos  Serviços De Manutenção De Edificações,1970.1282023043914,-6,189,195
11,Doutorado,5151,Trabalhadores Em Serviços De Promoção E Apoio À Saúde,3734.2077787552757,116,153,37
11,Doutorado,5152,Auxiliares De Laboratório Da Saúde,2757.998760919397,8,73,65
11,Doutorado,5153,"Trabalhadores De Atenção, Defesa E Proteção A Pessoas Em Situação De Risco E Adolescentes Em Conflito Com A Lei",2476.3338182159855,23,90,67
11,Doutorado,5162,"Cuidadores De Crianças, Jovens, Adultos E Idosos",2024.697543108905,-5,14,19
11,Doutorado,5163,"Tintureiros, Lavadeiros E Afins, A Máquina",1497.6380904760117,-9,5,14
11,Doutorado,5165,Trabalhadores Dos Serviços Funerários,1314.1714285714286,-7,14,21
11,Doutorado,5168,Esotéricos E Paranormais,3074.8701171875,-1,0,1
11,Doutorado,5171,"Bombeiros, Salva-Vidas E Afins",2498.3727530020255,-6,3,9
11,Doutorado,5172,"Policiais, Guardas-Civis Municipais E Agentes De Trânsito",1657.9375,0,2,2
11,Doutorado,5173,Vigilantes E Guardas De Segurança,6235.464350245824,-55,31,86
11,Doutorado,5174,"Porteiros, Vigias E Afins",1467.7775195518761,-41,86,127
11,Doutorado,5191,Motociclistas E Ciclistas De Entregas Rápidas,1268.122726686073,-11,11,22
11,Doutorado,5192,Trabalhadores Da Coleta E Seleção De Material Reciclável,1549.5,0,1,1
11,Doutorado,5193,"Trabalhadores De Serviços Veterinários, De Higiene E Estética De Animais Domésticos",1341.663335164388,0,10,10
11,Doutorado,5199,Outros Trabalhadores Dos Serviços,1813.5048136984806,26,196,170
11,Doutorado,5201,Supervisores De Vendas E De Prestação De Serviços,6824.1891524703415,-9,122,131
11,Doutorado,5211,Operadores Do Comércio Em Lojas E Mercados,3145.3754943957265,-173,707,880
11,Doutorado,5231,Instaladores De Produtos E Acessórios,1654.2428545270648,0,7,7
11,Doutorado,5241,Vendedores Em Domicílio,2781.8544281506147,-11,25,36
11,Doutorado,5242,"Vendedores Em Bancas, Quiosques E Barracas",660,0,1,1
11,Doutorado,5243,Vendedores Ambulantes,1800,-1,0,1
11,Doutorado,6110,Produtores Agropecuários Em Geral,1320,-1,0,1
11,Doutorado,6120,Produtores Agrícolas Polivalentes,2197,0,1,1
11,Doutorado,6121,Produtores Agrícolas Na Cultura De Gramíneas,17767.2001953125,0,1,1
11,Doutorado,6201,Supervisores Na Exploração Agropecuária,6269.432831556333,14,49,35
11,Doutorado,6210,Trabalhadores Agropecuários Em Geral,2453.097545695755,17,35,18
11,Doutorado,6220,Trabalhadores De Apoio À Agricultura,2594.2111428085636,25,51,26
11,Doutorado,6221,Trabalhadores Agrícolas Na Cultura De Gramíneas,2010.4305911064148,-17,16,33
11,Doutorado,6223,Trabalhadores Agrícolas Na Olericultura,1550,1,1,0
11,Doutorado,6224,Trabalhadores Agrícolas No Cultivo De Flores E Plantas Ornamentais,1125,0,1,1
11,Doutorado,6225,Trabalhadores Agrícolas Na Fruticultura,1147.1943603523316,10,21,11
11,Doutorado,6226,Trabalhadores Agrícolas Nas Culturas De Plantas Estimulantes,3842.199951171875,1,2,1
11,Doutorado,6227,Trabalhadores Agrícolas Na Cultura De Plantas Oleaginosas,2779,-2,0,2
11,Doutorado,6228,Trabalhadores Agrícolas Da Cultura De Especiarias E De Plantas Aromáticas E Medicinais,1540,1,1,0
11,Doutorado,6230,Tratadores Polivalentes De Animais,1980,1,1,0
11,Doutorado,6231,Trabalhadores Na Pecuária De Animais De Grande Porte,1389,4,5,1
11,Doutorado,6232,Trabalhadores Na Pecuária De Animais De Médio Porte,1733.1068059747868,-1,6,7
11,Doutorado,6233,Trabalhadores Na Avicultura E Cunicultura,4027.0926676432296,4,8,4
11,Doutorado,6301,Supervisores Na Área Florestal E Aqüicultura,5620.494959214155,-1,10,11
11,Doutorado,6313,Criadores De Animais Aquáticos,4825.186604817708,-1,1,2
11,Doutorado,6321,Extrativistas E Reflorestadores De Espécies Produtoras De Madeira,4207.170623779297,-3,3,6
11,Doutorado,6326,Carvoejadores,1350,-1,0,1
11,Doutorado,6410,Trabalhadores Da Mecanização Agrícola,1815.1990603777315,5,26,21
11,Doutorado,6420,Trabalhadores Da Mecanização Florestal,1848.7108154296875,1,3,2
11,Doutorado,6430,Trabalhadores Da Irrigação E Drenagem,3350,2,2,0
11,Doutorado,7101,Supervisores Da Extração Mineral,12762.026515415737,5,10,5
11,Doutorado,7102,Supervisores Da Construção Civil,3571.9719329833983,-1,10,11
11,Doutorado,7111,Trabalhadores Da Extração De Minerais Sólidos,1293.3499755859375,3,3,0
11,Doutorado,7112,Trabalhadores De Extração De Minerais Sólidos (Operadores De Máquinas),1798.1266479492188,1,3,2
11,Doutorado,7113,Trabalhadores Da Extração De Minerais Líquidos E Gasosos,3493.60009765625,-1,0,1
11,Doutorado,7121,Trabalhadores De Beneficiamento De Minérios,2094.675048828125,2,5,3
11,Doutorado,7122,Trabalhadores De Beneficiamento De Pedras Ornamentais,1302,1,1,0
11,Doutorado,7151,Trabalhadores Na Operação De Máquinas De Terraplenagem E Fundações,2303.233009153932,-7,11,18
11,Doutorado,7152,Trabalhadores De Estruturas De Alvenaria,2184.7216796875,-19,28,47
11,Doutorado,7153,Montadores De Estruturas De Concreto Armado,1783.482875279018,-3,2,5
11,Doutorado,7154,Trabalhadores Na Operação De Máquinas De Concreto Usinado E Afins,2213.8250732421875,0,1,1
11,Doutorado,7155,"Trabalhadores De Montagem De Estruturas De Madeira, Metal E Compósitos Em Obras Civis",2021.5692905970982,-3,14,17
11,Doutorado,7156,Trabalhadores De Instalações Elétricas,21548.549329708785,-3,22,25
11,Doutorado,7157,Aplicadores De Materiais Isolantes,2074.2099609375,1,1,0
11,Doutorado,7163,Vidraceiros (Revestimentos Rígidos),2281.0630727914663,-3,5,8
11,Doutorado,7164,Gesseiros,1383.800048828125,-1,0,1
11,Doutorado,7165,"Aplicadores De Revestimentos Cerâmicos, Pastilhas, Pedras E Madeiras",2131.2733357747397,-1,2,3
11,Doutorado,7166,Pintores De Obras E Revestidores De Interiores (Revestimentos Flexíveis),1729.1589650121227,-3,13,16
11,Doutorado,7170,Ajudantes De Obras Civis,1740.4052778603375,-10,65,75
11,Doutorado,7201,"Supervisores De Usinagem, Conformação E Tratamento De Metais",12455.412780761719,-5,0,5
11,Doutorado,7202,Supervisores Da Fabricação E Montagem Metalmecânica,6829.806722005208,-1,3,4
11,Doutorado,7211,Ferramenteiros E Afins,3844.946736653646,4,5,1
11,Doutorado,7212,Preparadores E Operadores De Máquinas-Ferramenta Convencionais,2337.614057268415,-6,15,21
11,Doutorado,7213,Afiadores E Polidores De Metais,1988.135009765625,-3,0,3
11,Doutorado,7214,Operadores De Máquinas De Usinagem Cnc,2070.7777506510415,0,4,4
11,Doutorado,7222,Trabalhadores De Fundição De Metais Puros E De Ligas Metálicas,1573.75,-2,0,2
11,Doutorado,7224,Trabalhadores De Trefilação E Estiramento De Metais Puros E Ligas Metálicas,1535.5999755859375,1,1,0
11,Doutorado,7231,Trabalhadores De Tratamento Térmico De Metais,4021.28515625,-2,0,2
11,Doutorado,7233,"Trabalhadores Da Pintura De Equipamentos, Veículos, Estruturas Metálicas E De Compósitos",1904.0085370744978,-3,7,10
11,Doutorado,7241,Encanadores E Instaladores De Tubulações,2253.2795944213867,-4,12,16
11,Doutorado,7242,Trabalhadores De Traçagem E Montagem De Estruturas Metálicas E De Compósitos,1735.8120236087154,2,10,8
11,Doutorado,7243,Trabalhadores De Soldagem E Corte De Ligas Metálicas,2030.3870634191176,4,19,15
11,Doutorado,7244,Trabalhadores De Caldeiraria E Serralheria,2507.240975516183,-2,10,12
11,Doutorado,7245,Operadores De Máquinas De Conformação De Metais,3579.02490234375,-2,0,2
11,Doutorado,7250,Ajustadores Mecânicos Polivalentes E Afins,2922.5000244140624,-2,2,4
11,Doutorado,7251,"Montadores De Máquinas, Aparelhos E Acessórios Em Linhas De Montagem",1825.5599772135417,1,2,1
11,Doutorado,7252,Montadores De Máquinas Industriais,1888.4479736328126,1,3,2
11,Doutorado,7253,Montadores De Máquinas Pesadas E Equipamentos Agrícolas,1821.530029296875,1,1,0
11,Doutorado,7254,Mecânicos Montadores De Motores E Turboalimentadores,2760,-1,0,1
11,Doutorado,7255,Montadores De Veículos Automotores (Linha De Montagem),1686.145004272461,-4,9,13
11,Doutorado,7257,Instaladores De Equipamentos De Refrigeração E Ventilação,1582.2862548828125,-2,3,5
11,Doutorado,7301,Supervisores De Montagens E Instalações Eletroeletrônicas,14216.23486328125,-2,0,2
11,Doutorado,7311,Montadores De Equipamentos Eletroeletrônicos,1943.1412667348875,-57,1,58
11,Doutorado,7313,Instaladores-Reparadores De  Linhas E Equipamentos De Telecomunicações,1371.3145453559027,-4,10,14
11,Doutorado,7321,"Instaladores E Reparadores De Linhas E Cabos Elétricos, Telefônicos E De Comunicação De Dados",1409.602482226348,-43,17,60
11,Doutorado,7401,Supervisores Da Mecânica De Precisão E Instrumentos Musicais,4481.72998046875,1,1,0
11,Doutorado,7411,Mecânicos De Instrumentos De Precisão,651,1,1,0
11,Doutorado,7502,"Supervisores De Vidraria, Cerâmica E Afins",3610.97998046875,0,2,2
11,Doutorado,7523,Ceramistas (Preparação E Fabricação),8838.533325195313,-1,1,2
11,Doutorado,7524,Vidreiros E Ceramistas (Arte E Decoração),1797.4000244140625,0,1,1
11,Doutorado,7601,Supervisores Da Indústria Têxtil,4400,1,1,0
11,Doutorado,7602,Supervisores Na Indústria Do Curtimento,8200,0,1,1
11,Doutorado,7603,Supervisores Na Confecção Do Vestuário,4642.7750244140625,-2,1,3
11,Doutorado,7604,Supervisores Na Confecção De Calçados,2750,-4,0,4
11,Doutorado,7606,Supervisores Das Artes Gráficas,8257.857142857143,-1,3,4
11,Doutorado,7610,Trabalhadores Polivalentes Das Indústrias Têxteis,1075.6566975911458,-3,0,3
11,Doutorado,7613,Operadores De Tear E Máquinas Similares,1333.3333333333333,-3,0,3
11,Doutorado,7614,"Trabalhadores De Acabamento, Tingimento E Estamparia Das Indústrias Têxteis",2372.2850341796875,-2,0,2
11,Doutorado,7618,Inspetores E Revisores De Produção Têxtil,1969.6600036621094,-3,0,3
11,Doutorado,7620,Trabalhadores Polivalentes Do Curtimento De Couros E Peles,1750,-1,0,1
11,Doutorado,7621,Trabalhadores Da Preparação Do Curtimento De Couros E Peles,1717,0,1,1
11,Doutorado,7623,Trabalhadores Do Acabamento De Couros E Peles,3810.39990234375,-1,0,1
11,Doutorado,7630,Profissionais Polivalentes Da Confecção De Roupas,2477.969970703125,-2,0,2
11,Doutorado,7631,Trabalhadores Da Preparação Da Confecção De Roupas,1369.7799682617188,-3,1,4
11,Doutorado,7632,Operadores De Máquinas Para Costura De Peças Do Vestuário,1542.7048171817555,-12,15,27
11,Doutorado,7633,Operadores De Máquinas Para Bordado E Acabamento De Roupas,1311.739990234375,0,1,1
11,Doutorado,7640,Trabalhadores Polivalentes Da Confecção De Calçados,1688.4700113932292,-4,1,5
11,Doutorado,7641,Trabalhadores Da Preparação Da Confecção De Calçados,1118.9333130807588,-4,8,12
11,Doutorado,7642,Operadores De Máquinas De Costurar E Montar Calçados,967.0683186848958,-8,0,8
11,Doutorado,7643,Trabalhadores De Acabamento De Calçados,1339.800048828125,0,1,1
11,Doutorado,7652,"Trabalhadores Da Confecção De Artefatos De Tecidos, Couros E Sintéticos",874.7866756358045,0,24,24
11,Doutorado,7661,Trabalhadores Da Pré-Impressão Gráfica,5063.273428883272,1,13,12
11,Doutorado,7662,Trabalhadores Da Impressão Gráfica,3937.356231689453,2,4,2
11,Doutorado,7663,Trabalhadores Do Acabamento Gráfico,1492.9349822998047,-3,2,5
11,Doutorado,7664,Trabalhadores De Laboratório Fotográfico E Radiológico,2458.5,0,1,1
11,Doutorado,7683,Trabalhadores Artesanais Da Confecção De Calçados E Artefatos De Couros E Peles,1281.5,-2,1,3
11,Doutorado,7686,Trabalhadores Tipográficos Linotipistas E Afins,1370.3699951171875,1,1,0
11,Doutorado,7701,"Supervisores Em Indústria De Madeira, Mobiliário E Da Carpintaria Veicular",1972.63671875,1,2,1
11,Doutorado,7711,Marceneiros E Afins,1683.5314069475446,1,4,3
11,Doutorado,7721,Trabalhadores De Tratamento E Preparação Da Madeira,1445.4219970703125,2,4,2
11,Doutorado,7733,Operadores De Usinagem Convencional De Madeira,3465,-2,0,2
11,Doutorado,7735,Operadores De Máquinas De Usinagem De Madeira Cnc,3143.800048828125,1,1,0
11,Doutorado,7741,Montadores De Móveis E Artefatos De Madeira,1636.6800130208333,1,2,1
11,Doutorado,7801,Supervisores De Trabalhadores De Embalagem E Etiquetagem,2993.510009765625,-1,0,1
11,Doutorado,7813,Operadores De Equipamentos Pilotados Remotamente,4977.5498046875,-1,0,1
11,Doutorado,7821,Operadores De Máquinas E Equipamentos De Elevação,2076.2804992675783,-4,3,7
11,Doutorado,7822,Operadores De Equipamentos De Movimentação De Cargas,2142.6016676161025,-6,15,21
11,Doutorado,7823,Motoristas De Veículos De Pequeno E Médio Porte,1762.777196616461,-4,32,36
11,Doutorado,7824,"Motoristas De Ônibus Urbanos, Metropolitanos E Rodoviários",2339.0595984925617,-5,41,46
11,Doutorado,7825,Motoristas De Veículos De Cargas Em Geral,4101.6335010700395,-22,71,93
11,Doutorado,7826,Operadores De Veículos Sobre Trilhos E Cabos Aéreos,3440,-1,0,1
11,Doutorado,7827,Trabalhadores Aquaviários,1321.306688096788,0,3,3
11,Doutorado,7831,Trabalhadores De Manobras De Transportes Sobre Trilhos,1610.4099934895835,2,5,3
11,Doutorado,7832,Trabalhadores De Cargas E Descargas De Mercadorias,1528.155731094467,-36,38,74
11,Doutorado,7841,Trabalhadores De Embalagem E De Etiquetagem,1792.7912536621095,-11,27,38
11,Doutorado,7842,Alimentadores De Linhas De Produção,4633.16619512319,-9,207,216
11,Doutorado,7911,Artesãos,1153,2,3,1
11,Doutorado,8101,"Supervisores De Produção Em Indústrias Químicas, Petroquímicas E Afins",6055.010689871651,-4,2,6
11,Doutorado,8102,Supervisores De Produção Em Indústrias De Transformação De Plásticos E Borrachas,14555.9599609375,-1,0,1
11,Doutorado,8103,"Supervisores De Produção Em Indústrias De Produtos Farmacêuticos, Cosméticos E Afins",13150.644422743055,1,5,4
11,Doutorado,8110,"Operadores Polivalentes De Equipamentos Em Indústrias Químicas, Petroquímicas E Afins",10607.917166573661,-5,1,6
11,Doutorado,8113,Operadores De Equipamentos De Filtragem E Separação,5398.6849365234375,-2,3,5
11,Doutorado,8114,"Operadores De Equipamentos De Destilação, Evaporação E Reação",2877.6777682834204,1,4,3
11,Doutorado,8115,Operadores De Equipamentos De Produção E Refino De Petróleo E Gás,4691.919921875,0,1,1
11,Doutorado,8116,Operadores De Equipamentos De Coqueificação,2776.340087890625,-1,0,1
11,Doutorado,8117,"Operadores De Instalações E Máquinas De Produtos Plásticos, De Borracha E Moldadores De Parafinas",2104.2162475585938,0,3,3
11,Doutorado,8118,"Operadores De Máquinas E Instalações De Produtos Farmacêuticos, Cosméticos E Afins",2139.140848795573,-3,1,4
11,Doutorado,8131,"Operadores De Processos Das Indústrias De Transformação De Produtos Químicos, Petroquímicos E Afins",4504.83042064408,2,17,15
11,Doutorado,8181,Laboratoristas Industriais Auxiliares,3880.2441489152625,9,74,65
11,Doutorado,8201,Supervisores De Produção Em Indústrias Siderúrgicas,7546.56005859375,-2,0,2
11,Doutorado,8211,Operadores De Instalações De Sinterização,1943.9649658203125,2,2,0
11,Doutorado,8212,Operadores De Fornos De Primeira  Fusão E Aciaria,2056.5,-1,1,2
11,Doutorado,8213,Operadores De Equipamentos De Laminação,2635.9199829101563,1,2,1
11,Doutorado,8214,Operadores De Equipamentos De Acabamento De Chapas E Metais,3547.2833862304688,-1,4,5
11,Doutorado,8233,Operadores De Instalações E Equipamentos De Fabricação De Materiais De Construção,1997.5999755859375,1,1,0
11,Doutorado,8301,Supervisores Da Fabricação De Celulose E Papel,6540.167131696428,-1,3,4
11,Doutorado,8321,Operadores De Máquinas De Fabricar Papel E Papelão,3150.8199869791665,-2,1,3
11,Doutorado,8331,Operadores De Máquinas Na Fabricação De Produtos De Papel E Papelão,2303.39990234375,-4,0,4
11,Doutorado,8401,"Supervisores Da Fabricação De Alimentos, Bebidas E Fumo",6404.836082458496,3,21,18
11,Doutorado,8411,"Trabalhadores Da Indústria De Beneficiamento De Grãos, Cereais E Afins",1434,0,1,1
11,Doutorado,8413,Trabalhadores Na Fabricação E Refino De Açúcar,1462.2200012207031,1,2,1
11,Doutorado,8414,Trabalhadores Na Fabricação E Conservação De Alimentos,1621.6116604275173,-3,5,8
11,Doutorado,8415,Trabalhadores Na Pasteurização Do Leite E Na Fabricação De Laticínios  E Afins,2144.2023080679087,5,9,4
11,Doutorado,8416,"Trabalhadores Na Industrialização De Café, Cacau, Mate E De Produtos Afins",1685.7099609375,-1,0,1
11,Doutorado,8417,"Trabalhadores Na Fabricação De Cachaça, Cerveja, Vinhos E Outras Bebidas",5287.974751790364,0,5,5
11,Doutorado,8418,"Operadores De Equipamentos Na Fabricação De Pães, Massas Alimentícias, Doces, Chocolates E Achocolatados",1528.780029296875,-2,0,2
11,Doutorado,8483,"Padeiros, Confeiteiros E Afins",1583.7077813042536,-2,9,11
11,Doutorado,8484,Trabalhadores Na Degustação E Classificação De Grãos E Afins,1622.0580078125,-1,2,3
11,Doutorado,8485,Magarefes E Afins,1707.2366810099284,-16,33,49
11,Doutorado,8601,Supervisores Da Produção De Utilidades,4953.773335375817,-2,12,14
11,Doutorado,8612,Operadores De Instalações De Distribuição De Energia Elétrica,5843.5,2,2,0
11,Doutorado,8621,Operadores De Máquinas A Vapor E Utilidades,1613.4536115121148,-5,10,15
11,Doutorado,8622,"Operadores De Instalações De Captação, Tratamento E Distribuição De Água",2103.883984375,-1,2,3
11,Doutorado,8623,Operadores De Instalações De Captação E Esgotos,2339.3426298253676,-3,8,11
11,Doutorado,9101,"Supervisores Em Serviços De Reparação E Manutenção De Máquinas E Equipamentos Industriais, Comerciais E Residenciais",6060.274226888021,-6,7,13
11,Doutorado,9102,Supervisores Em Serviços De Reparação E Manutenção Veicular,3434.9360107421876,1,4,3
11,Doutorado,9109,"Supervisores De Outros Trabalhadores De Serviços De Reparação, Conservação E Manutenção",12097.990234375,0,1,1
11,Doutorado,9111,"Mecânicos De Manutenção De Bombas, Motores, Compressores E Equipamentos De Transmissão",1845.5332845052085,0,2,2
11,Doutorado,9112,Mecânicos De Manutenção E Instalação De Aparelhos De  Climatização E Refrigeração,1471.6424865722656,-2,1,3
11,Doutorado,9113,Mecânicos De Manutenção De Máquinas Industriais,3091.7982549252715,-6,20,26
11,Doutorado,9131,Mecânicos De Manutenção De Máquinas Pesadas E Equipamentos Agrícolas,2518.1600613064234,1,5,4
11,Doutorado,9141,Mecânicos De Manutenção Aeronáutica,5138.431379045759,1,4,3
11,Doutorado,9144,Mecânicos De Manutenção De Veículos Automotores,2808.612624574319,-11,17,28
11,Doutorado,9151,Técnicos Em Manutenção E Reparação De Instrumentos De Medição E Precisão,3644.4400390625,0,3,3
11,Doutorado,9153,Técnicos Em Manutenção E Reparação De Equipamentos Biomédicos,6412.897686298077,1,7,6
11,Doutorado,9191,Lubrificadores,1527.7262725830078,-1,2,3
11,Doutorado,9192,"Trabalhadores De Manutenção De Roçadeiras, Motoserras E Similares",2261.9999389648438,-2,0,2
11,Doutorado,9501,"Supervisores De Manutenção Eletroeletrônica Industrial, Comercial E Predial",5036.070115831163,-7,5,12
11,Doutorado,9503,Supervisores De Manutenção Eletromecânica,6661.987487792969,-2,1,3
11,Doutorado,9511,Eletricistas De Manutenção Eletroeletrônica,2486.4846059438346,-7,15,22
11,Doutorado,9513,Instaladores E Mantenedores De Sistemas Eletroeletrônicos De Segurança,2229.72710164388,-2,6,8
11,Doutorado,9531,"Eletricistas Eletrônicos De Manutenção Veicular (Aérea, Terrestre E Naval)",3801.67333984375,0,2,2
11,Doutorado,9541,"Instaladores E Mantenedores Eletromecânicos De Elevadores, Escadas E Portas Automáticas",2427.7188788519966,1,5,4
11,Doutorado,9542,Reparadores De Aparelhos Eletrodomésticos,1509.553328450521,2,9,7
11,Doutorado,9913,Reparadores De Carrocerias De Veículos,1526.239990234375,-1,1,2
11,Doutorado,9921,Trabalhadores Elementares De Serviços De Manutenção Veicular,2275.3499755859375,0,4,4
11,Doutorado,9922,Trabalhadores Operacionais De Conservação De Vias Permanentes (Exceto Trilhos),2005.6414330911914,-1,13,14
80,Pós-Graduação completa,0000,Não especificado,5043.5562681424235,135,587,452
80,Pós-Graduação completa,0101,Oficiais Generais Das Forças Armadas,14403.309368664704,15,49,34
80,Pós-Graduação completa,0102,Oficiais Das Forças Armadas,18980,1,1,0
80,Pós-Graduação completa,0103,Praças Das Forças Armadas,1712.9066569010417,1,2,1
80,Pós-Graduação completa,0201,Oficiais Superiores Da Polícia Militar,2500,1,1,0
80,Pós-Graduação completa,0212,Cabos E Soldados Da Polícia Militar,6000,1,1,0
80,Pós-Graduação completa,0312,Cabos E Soldados Do Corpo De Bombeiros Militar,6275,1,1,0
80,Pós-Graduação completa,1111,Legisladores,7753.770219106523,4,18,14
80,Pós-Graduação completa,1112,Dirigentes Gerais Da Administração Pública,4581.185321461071,5,49,44
80,Pós-Graduação completa,1113,Magistrados,31916.669921875,1,1,0
80,Pós-Graduação completa,1114,Dirigentes Do Serviço Público,9708.973909521648,115,276,161
80,Pós-Graduação completa,1115,Gestores Públicos,9447.496312558224,143,580,437
80,Pós-Graduação completa,1130,"Dirigentes De Povos Indígenas, De Quilombolas E Caiçaras",2050.2249755859375,0,2,2
80,Pós-Graduação completa,1141,Dirigentes De Partidos Políticos,15120,0,2,2
80,Pós-Graduação completa,1142,Dirigentes E Administradores De Entidades Patronais E Dos Trabalhadores E De Outros Interesses Sócioeconômicos,6772.575214688741,8,19,11
80,Pós-Graduação completa,1143,Dirigentes E Administradores De Entidades Religiosas,3683.8209373837426,5,13,8
80,Pós-Graduação completa,1144,Dirigentes E Administradores De Organizações Da Sociedade Civil Sem Fins Lucrativos,12866.70517985026,4,23,19
80,Pós-Graduação completa,1210,Diretores Gerais,33598.527470389556,40,1235,1195
80,Pós-Graduação completa,1221,"Diretores De Produção E Operações Em Empresa Agropecuária, Pesqueira , Aqüícola E Florestal",35755.13461961933,5,28,23
80,Pós-Graduação completa,1222,"Diretores De Produção E Operações Em Empresa Da Indústria Extrativa, Transformação E De Serviços De Utilidade Pública",37223.734372384206,-16,132,148
80,Pós-Graduação completa,1223,Diretores De Operações De Obras Em Empresa De Construção,30638.893425143495,9,54,45
80,Pós-Graduação completa,1224,Diretores De Operações Em Empresa Do Comércio,33452.46703741017,-21,108,129
80,Pós-Graduação completa,1225,"Diretores De Serviços De Turismo, De Alojamento E De Alimentação",84012.5588420521,-4,53,57
80,Pós-Graduação completa,1226,"Diretores De Operações De Serviços Em Empresa De Armazenamento, De Transporte E De Telecomunicação",24377.91590123968,-5,152,157
80,Pós-Graduação completa,1227,Diretores De Operações De Serviços Em Instituição De Intermediação Financeira,27611.93356170052,1,381,380
80,Pós-Graduação completa,1231,Diretores Administrativos E Financeiros,32477.89631068593,-162,2429,2591
80,Pós-Graduação completa,1232,Diretores De Recursos Humanos E Relações De Trabalho,31609.222815863614,13,417,404
80,Pós-Graduação completa,1233,Diretores De Comercialização E Marketing,35376.36645695153,-55,1861,1916
80,Pós-Graduação completa,1234,Diretores De Suprimentos E Afins,17691.784295784953,-13,158,171
80,Pós-Graduação completa,1236,Diretores De Tecnologia Da Informação,35743.25895198699,76,535,459
80,Pós-Graduação completa,1237,Diretores De Pesquisa E Desenvolvimento,31715.342587875508,-19,152,171
80,Pós-Graduação completa,1238,Diretores De Manutenção,29983.950260128597,-25,44,69
80,Pós-Graduação completa,1311,"Diretores E Gerentes De Operações Em Empresa De Serviços Pessoais, Sociais E Culturais",11180.030224916018,36,1151,1115
80,Pós-Graduação completa,1312,"Gestores E Especialistas De Operações Em Empresas, Secretarias E Unidades De Serviços De Saúde",9409.795897721826,223,2386,2163
80,Pós-Graduação completa,1313,Diretores E Gerentes De Instituição De Serviços Educacionais,6733.002589155522,-118,1325,1443
80,Pós-Graduação completa,1411,"Gerentes De Produção E Operações Em Empresa Agropecuária, Pesqueira, Aqüícola E Florestal",12219.982169782435,-20,206,226
80,Pós-Graduação completa,1412,"Gerentes De Produção E Operações Em Empresa Da Indústria Extrativa, De Transformação E De Serviços De Utilidade Pública",14126.075061209753,-289,3159,3448
80,Pós-Graduação completa,1413,Gerentes De Obras Em Empresa De Construção,13034.862179277878,62,854,792
80,Pós-Graduação completa,1414,Gerentes De Operações Comerciais E De Assistência Técnica,6478.313278418145,-206,1997,2203
80,Pós-Graduação completa,1415,"Gerentes De Operações De Serviços Em Empresa De Turismo, De Alojamento E Alimentação",8493.02313204803,-105,842,947
80,Pós-Graduação completa,1416,"Gerentes De Operações De Serviços Em Empresa De Transporte, De Comunicação E De Logística (Armazenagem E Distribuição)",12436.99542421583,-220,2533,2753
80,Pós-Graduação completa,1417,Gerentes De Operações De Serviços Em Instituição De Intermediação Financeira,11265.696619627231,-990,3309,4299
80,Pós-Graduação completa,1418,Gerentes Operacionais Da Aviação Civil,13033.937825863486,16,30,14
80,Pós-Graduação completa,1421,"Gerentes Administrativos, Financeiros, De Riscos E Afins",11016.156615462936,-619,18640,19259
80,Pós-Graduação completa,1422,Gerentes De Recursos Humanos E De Relações Do Trabalho,9014.438459899748,-452,7631,8083
80,Pós-Graduação completa,1423,"Gerentes De Comercialização, Marketing E Comunicação",9859.33147462782,4917,48758,43841
80,Pós-Graduação completa,1424,Gerentes De Suprimentos E Afins,12484.132181243325,30,2435,2405
80,Pós-Graduação completa,1425,Gerentes De Tecnologia Da Informação,14685.904044084911,2025,11824,9799
80,Pós-Graduação completa,1426,Gerentes De Pesquisa E Desenvolvimento E Afins,14880.838774523392,64,2902,2838
80,Pós-Graduação completa,1427,Gerentes De Manutenção E Afins,9714.643921628813,231,2672,2441
80,Pós-Graduação completa,2011,Profissionais Da Biotecnologia,7550.742359291068,9,68,59
80,Pós-Graduação completa,2012,Profissionais Da Metrologia,6327.306224190848,2,28,26
80,Pós-Graduação completa,2021,"Engenheiros De Controle E Automação, Engenheiros Mecatrônicos E Afins",28718.130335439426,73,416,343
80,Pós-Graduação completa,2030,Pesquisadores Das Ciências Biológicas,6691.189115253956,43,176,133
80,Pós-Graduação completa,2031,Pesquisadores Das Ciências Naturais E Exatas,6749.866727884873,168,526,358
80,Pós-Graduação completa,2032,Pesquisadores De Engenharia E Tecnologia,11177.602343186032,112,1129,1017
80,Pós-Graduação completa,2033,Pesquisadores Das Ciências Da Saúde,8735.78484299352,102,522,420
80,Pós-Graduação completa,2034,Pesquisadores Das Ciências Da Agricultura,8377.67331001483,56,117,61
80,Pós-Graduação completa,2035,Pesquisadores Das Ciências Sociais E Humanas,7017.660959522592,-12,213,225
80,Pós-Graduação completa,2041,Peritos Criminais E Judiciais,11532.3251953125,-2,1,3
80,Pós-Graduação completa,2111,Profissionais Da Matemática,10085.969910999387,68,495,427
80,Pós-Graduação completa,2112,Profissionais De Estatística E Afins,9471.622247460386,44,301,257
80,Pós-Graduação completa,2122,Engenheiros Em Computação,13141.408797378543,946,2815,1869
80,Pós-Graduação completa,2123,Administradores De Tecnologia Da Informação,9392.655285128221,1069,5325,4256
80,Pós-Graduação completa,2124,Analistas De Tecnologia Da Informação,8313.9348564268,5092,42066,36974
80,Pós-Graduação completa,2131,Físicos,5797.3300497879445,-8,32,40
80,Pós-Graduação completa,2132,Químicos,7396.192909557064,-31,207,238
80,Pós-Graduação completa,2133,Profissionais Das Ciências Atmosféricas E Espaciais E De Astronomia,8461.960123697916,-2,5,7
80,Pós-Graduação completa,2134,"Geólogos, Oceanógrafos, Geofísicos E Afins",9523.681578462958,20,246,226
80,Pós-Graduação completa,2140,Engenheiros Ambientais E Afins,7839.3473380217165,87,642,555
80,Pós-Graduação completa,2141,Arquitetos E Urbanistas,8582.919297279419,78,848,770
80,Pós-Graduação completa,2142,Engenheiros Civis E Afins,12001.009739815452,297,4895,4598
80,Pós-Graduação completa,2143,"Engenheiros Eletricistas, Eletrônicos E Afins",10677.751708875867,-167,2115,2282
80,Pós-Graduação completa,2144,Engenheiros Mecânicos E Afins,11582.66933038303,8,2071,2063
80,Pós-Graduação completa,2145,Engenheiros Químicos E Afins,14654.086826609873,-83,394,477
80,Pós-Graduação completa,2146,"Engenheiros Metalurgistas, De Materiais E Afins",11078.809709221765,-50,175,225
80,Pós-Graduação completa,2147,Engenheiros De Minas E Afins,12901.201613120877,809,1240,431
80,Pós-Graduação completa,2148,Engenheiros Agrimensores E Engenheiros Cartógrafos,8250.246493458346,4,40,36
80,Pós-Graduação completa,2149,"Engenheiros De Produção, Qualidade, Segurança E Afins",11135.118371904602,860,7918,7058
80,Pós-Graduação completa,2151,Oficiais De Convés E Afins,8540.277905975057,20,249,229
80,Pós-Graduação completa,2152,Oficiais De Máquinas Da Marinha Mercante,9786.238788020783,44,195,151
80,Pós-Graduação completa,2153,Profissionais Da Pilotagem Aeronáutica,7614.026103449635,59,271,212
80,Pós-Graduação completa,2211,Biólogos E Afins,4284.214902031011,-28,450,478
80,Pós-Graduação completa,2212,Biomédicos,3185.174559412861,344,2594,2250
80,Pós-Graduação completa,2221,Engenheiros Agrossilvipecuários,7446.138481233861,-52,549,601
80,Pós-Graduação completa,2222,Engenheiros De Alimentos E Afins,6743.619920037989,10,51,41
80,Pós-Graduação completa,2232,Cirurgiões-Dentistas,5788.006315674684,813,2260,1447
80,Pós-Graduação completa,2233,Veterinários E Zootecnistas,5318.990979334402,67,619,552
80,Pós-Graduação completa,2234,Farmacêuticos,6480.669591779946,339,10200,9861
80,Pós-Graduação completa,2235,Enfermeiros E Afins,4873.831868963157,5067,46381,41314
80,Pós-Graduação completa,2236,Fisioterapeutas,3263.358992058777,1971,10553,8582
80,Pós-Graduação completa,2237,Nutricionistas,3228.4017646134116,657,4596,3939
80,Pós-Graduação completa,2238,Fonoaudiólogos,3679.1162201295806,339,2063,1724
80,Pós-Graduação completa,2239,"Terapeutas Ocupacionais, Ortoptistas E Psicomotricistas",2876.736812246734,282,1461,1179
80,Pós-Graduação completa,2241,Profissionais Da Educação Física,4578.13039121763,-1,2575,2576
80,Pós-Graduação completa,2251,Médicos Clínicos,7901.682016056064,1770,14411,12641
80,Pós-Graduação completa,2252,Médicos Em Especialidades Cirúrgicas,9585.917421015645,511,1696,1185
80,Pós-Graduação completa,2253,Médicos Em Medicina Diagnóstica E Terapêutica,9949.415297676636,103,287,184
80,Pós-Graduação completa,2261,Osteopatas E Quiropraxistas,1973.5349731445313,0,1,1
80,Pós-Graduação completa,2263,"Profissionais Das Terapias Criativas,Equoterápicas E Naturológicas",2321.227843566168,28,66,38
80,Pós-Graduação completa,2311,Professores De Nível Superior Na Educação Infantil,2937.9032269118147,696,6316,5620
80,Pós-Graduação completa,2312,Professores De Nível Superior Do Ensino Fundamental (Primeira A Quarta Séries),7258.967853370708,2152,13761,11609
80,Pós-Graduação completa,2313,Professores De Nível Superior No Ensino Fundamental De Quinta A Oitava Série,3263.564501145053,1081,7265,6184
80,Pós-Graduação completa,2321,Professores Do Ensino Médio,5888.5503139385955,786,7337,6551
80,Pós-Graduação completa,2331,Professores Do Ensino Profissional,5402.242557578899,-215,1122,1337
80,Pós-Graduação completa,2332,Instrutores De Ensino Profissional,6004.297582561623,1231,6381,5150
80,Pós-Graduação completa,2341,"Professores De Matemática, Estatística E Informática Do Ensino Superior",2499.8891556739623,-196,625,821
80,Pós-Graduação completa,2342,"Professores De Ciências Físicas, Químicas E Afins Do Ensino Superior",10708.081071490333,-21,29,50
80,Pós-Graduação completa,2343,"Professores De Arquitetura E Urbanismo, Engenharia, Geofísica E Geologia Do Ensino Superior",3728.392544303054,-282,386,668
80,Pós-Graduação completa,2344,Professores De Ciências Biológicas E Da Saúde Do Ensino Superior,5194.377071902006,1762,4998,3236
80,Pós-Graduação completa,2345,Professores Na Área De Formação Pedagógica Do Ensino Superior,3640.4424760912752,7139,38979,31840
80,Pós-Graduação completa,2346,Professores Nas Áreas De Língua E Literatura Do Ensino Superior,24732.849001002884,67,3113,3046
80,Pós-Graduação completa,2347,Professores De Ciências Humanas Do Ensino Superior,2080.6212310104033,-107,1788,1895
80,Pós-Graduação completa,2348,"Professores De Ciências Econômicas, Administrativas E Contábeis Do Ensino Superior",3710.598006510556,-400,1368,1768
80,Pós-Graduação completa,2349,Professores De Artes Do Ensino Superior,6088.485342771603,-11,162,173
80,Pós-Graduação completa,2392,Professores De Educação Especial,3379.5438961859572,785,2144,1359
80,Pós-Graduação completa,2394,"Programadores, Avaliadores E Orientadores De Ensino",3167.7300525252317,5717,22725,17008
80,Pós-Graduação completa,2410,Advogados,9114.301564677786,1382,10202,8820
80,Pós-Graduação completa,2412,Procuradores E Advogados Públicos,10857.30218622117,-1,15,16
80,Pós-Graduação completa,2413,Tabeliães E Registradores,5506.928471583756,-33,64,97
80,Pós-Graduação completa,2422,Membros Do Ministério Público,7312.83984375,1,1,0
80,Pós-Graduação completa,2423,Delegados De Polícia,3692.090087890625,-1,0,1
80,Pós-Graduação completa,2424,Defensores Públicos E Procuradores Da Assistência Judiciária,4364.903706607655,-7,14,21
80,Pós-Graduação completa,2429,Profissionais Da Inteligência,11238.511090294789,19,43,24
80,Pós-Graduação completa,2511,Profissionais Em Pesquisa E Análise Antropológica Sociológica,7048.201023656453,9,57,48
80,Pós-Graduação completa,2512,Economistas,7175.785953837828,130,4365,4235
80,Pós-Graduação completa,2513,Profissionais Em Pesquisa E Análise Geográfica,5810.960806710379,2,50,48
80,Pós-Graduação completa,2514,Filósofos,0,-1,0,1
80,Pós-Graduação completa,2515,Psicólogos E Psicanalistas,3442.3215225699123,1359,5862,4503
80,Pós-Graduação completa,2516,Assistentes Sociais E Economistas Domésticos,4921.399129706424,630,3800,3170
80,Pós-Graduação completa,2521,Administradores,7060.106652267532,827,21535,20708
80,Pós-Graduação completa,2522,Contadores E Afins,8114.2987728173075,-831,17114,17945
80,Pós-Graduação completa,2523,Secretárias(Os) Executivas(Os) E Afins,5344.080472785403,23,3234,3211
80,Pós-Graduação completa,2524,Profissionais De Recursos Humanos,5403.062605887626,719,18810,18091
80,Pós-Graduação completa,2525,Profissionais De Administração Ecônomico-Financeira,8969.164098423695,1072,9327,8255
80,Pós-Graduação completa,2526,Profissionais Da Administração Dos Serviços De Segurança,12076.070040281213,102,358,256
80,Pós-Graduação completa,2527,"Profissionais De Planejamento, Programação E Controles Logisticos",5343.753049333387,626,2288,1662
80,Pós-Graduação completa,2531,Profissionais De Publicidade,8655.59121744245,-263,3958,4221
80,Pós-Graduação completa,2532,Profissionais De Comercializacão E Consultoria De Serviços Bancários,11889.67551208605,-879,7557,8436
80,Pós-Graduação completa,2533,"Corretores De Valores, Ativos Financeiros, Mercadorias E Derivativos",8526.540261702105,60,294,234
80,Pós-Graduação completa,2534,Profissionais De Mídias Digitais E Afins,5091.153758576913,205,398,193
80,Pós-Graduação completa,2541,Auditores Fiscais E Técnicos Da Receita Federal,8227,0,4,4
80,Pós-Graduação completa,2542,Auditores Fiscais Da Previdência Social,3597.969970703125,-1,0,1
80,Pós-Graduação completa,2543,Auditores Fiscais Do Trabalho,6191.439310396635,1,12,11
80,Pós-Graduação completa,2544,Fiscais De Tributos Estaduais E Municipais,6996.7431852121335,45,131,86
80,Pós-Graduação completa,2545,Profissionais Da Fiscalização De Atividades Urbanas,5283.550079345703,0,12,12
80,Pós-Graduação completa,2611,Profissionais Do Jornalismo,6576.068367752984,-245,1769,2014
80,Pós-Graduação completa,2612,Profissionais Da Informação,5624.651458185359,-9,2485,2494
80,Pós-Graduação completa,2613,Arquivistas E Museólogos,9132.696364769568,-30,100,130
80,Pós-Graduação completa,2614,"Filólogos,Tradutores ,Intérpretes E Afins",3303.116017382954,92,640,548
80,Pós-Graduação completa,2615,Profissionais Da Escrita,5758.432069625283,-9,187,196
80,Pós-Graduação completa,2616,Editores,7073.193149383942,-29,177,206
80,Pós-Graduação completa,2617,"Locutores, Comentaristas E Repórteres De Mídias Audiovisuais",5369.109172907045,-9,240,249
80,Pós-Graduação completa,2618,Fotógrafos Profissionais,3482.4263537399165,-11,29,40
80,Pós-Graduação completa,2619,Assistentes De Direção (Tv) E Continuístas,4010.5346330915177,1,6,5
80,Pós-Graduação completa,2621,Produtores Artísticos E Culturais,4769.261290171116,6,275,269
80,Pós-Graduação completa,2622,Diretores De Espetáculos E Afins,10477.565038278579,-14,52,66
80,Pós-Graduação completa,2623,Cenógrafos,4598.027744114083,8,115,107
80,Pós-Graduação completa,2624,"Artistas Visuais,Desenhistas Industriais E Conservadores-Restauradores De Bens Culturais",5937.7997182424315,617,3255,2638
80,Pós-Graduação completa,2625,Atores,4923.717503138951,-2,13,15
80,Pós-Graduação completa,2626,"Músicos Compositores, Arranjadores, Regentes E Musicólogos",2193.4223100283207,6,41,35
80,Pós-Graduação completa,2627,Músicos Intérpretes,3371.092152138551,4,37,33
80,Pós-Graduação completa,2628,Artistas Da Dança (Exceto Dança Tradicional E Popular),3154.6034563584935,-16,123,139
80,Pós-Graduação completa,2629,Designer De Interiores De Nível Superior,4900.393535983178,-14,24,38
80,Pós-Graduação completa,2631,"Ministros De Culto, Missionários, Teólogos E Profissionais Assemelhados",3109.925538938243,18,159,141
80,Pós-Graduação completa,2711,Chefes De Cozinha E Afins,3056.339871509377,48,264,216
80,Pós-Graduação completa,3001,Técnicos Em Mecatrônica,6400.161876694773,-21,101,122
80,Pós-Graduação completa,3003,Técnicos Em Eletromecânica,4322.645078482279,-7,99,106
80,Pós-Graduação completa,3011,Técnicos De Laboratório Industrial,4494.85180574869,-102,489,591
80,Pós-Graduação completa,3012,Técnicos De Apoio À Bioengenharia,133099.59521484375,-1,12,13
80,Pós-Graduação completa,3111,Técnicos Químicos,5698.12529382579,-73,631,704
80,Pós-Graduação completa,3112,"Técnicos De Produção De Indústrias Químicas, Petroquímicas, Refino De Petróleo, Gás E Afins",6032.028702445652,-1,11,12
80,Pós-Graduação completa,3113,"Técnicos Em Materiais, Produtos Cerâmicos E Vidros",5972.183478860294,-1,8,9
80,Pós-Graduação completa,3114,Técnicos Em Fabricação De Produtos Plásticos E De Borracha,5747.107371184786,7,35,28
80,Pós-Graduação completa,3115,"Técnicos Em Controle Ambiental, Utilidades E Tratamento De Efluentes",6594.961173571752,28,525,497
80,Pós-Graduação completa,3116,Técnicos Têxteis,6519.3921952097035,0,23,23
80,Pós-Graduação completa,3117,Coloristas,3199.3449617636325,-6,14,20
80,Pós-Graduação completa,3121,Técnicos Em Construção Civil (Edificações),4805.932148477789,72,1408,1336
80,Pós-Graduação completa,3122,Técnicos Em Construção Civil (Obras De Infraestrutura),5166.870646329298,-17,142,159
80,Pós-Graduação completa,3123,Técnicos Em Geomática,4467.789610009812,13,149,136
80,Pós-Graduação completa,3131,Técnicos Em Eletricidade E Eletrotécnica,5489.643412204117,-234,731,965
80,Pós-Graduação completa,3132,Técnicos Em Eletrônica,5958.93419541981,-342,1006,1348
80,Pós-Graduação completa,3133,Técnicos Em Telecomunicações,5179.1025263719475,-158,327,485
80,Pós-Graduação completa,3134,Técnicos Em Calibração E Instrumentação,11293.6866599716,-35,134,169
80,Pós-Graduação completa,3135,Técnicos Em Fotônica,2907.7260040283204,4,22,18
80,Pós-Graduação completa,3141,"Técnicos Mecânicos Na Fabricação E Montagem De Máquinas, Sistemas E Instrumentos",5007.82370965072,-69,350,419
80,Pós-Graduação completa,3142,Técnicos Mecânicos (Ferramentas),5436.046193283651,-1,118,119
80,Pós-Graduação completa,3143,Técnicos Em Mecânica Veicular,7007.267487031346,84,239,155
80,Pós-Graduação completa,3144,"Técnicos Mecânicos Na Manutenção De Máquinas, Sistemas E Instrumentos",4822.943556849708,-17,268,285
80,Pós-Graduação completa,3146,Técnicos Em Metalurgia (Estruturas Metálicas),6920.25098042372,-21,36,57
80,Pós-Graduação completa,3147,Técnicos Em Siderurgia,9964.889137724525,2,17,15
80,Pós-Graduação completa,3148,Especialistas Em Inspeções Industriais,6025.828444240855,6,24,18
80,Pós-Graduação completa,3161,Técnicos Em Geologia,4751.076213008718,-7,26,33
80,Pós-Graduação completa,3163,Técnicos Em Mineração,5783.276770946019,69,126,57
80,Pós-Graduação completa,3171,Técnicos De Desenvolvimento De Sistemas E Aplicações,6520.834474909219,157,6384,6227
80,Pós-Graduação completa,3172,Técnicos De Suporte E Monitoração Ao Usuário De Tecnologia Da Informação.,3332.329803030979,-450,1854,2304
80,Pós-Graduação completa,3180,"Desenhistas Técnicos, Em Geral",4134.077217393981,16,198,182
80,Pós-Graduação completa,3181,Desenhistas Técnicos Da Construção Civil E Arquitetura,4170.254505561711,0,111,111
80,Pós-Graduação completa,3182,Desenhistas Técnicos Da Mecânica,5539.601249533866,3,47,44
80,Pós-Graduação completa,3183,"Desenhistas Técnicos Em Eletricidade, Eletrônica, Eletromecânica, Calefação, Ventilação E Refrigeração",3931.5796366373697,-1,11,12
80,Pós-Graduação completa,3184,Desenhistas Técnicos De Produtos E Serviços Diversos,4658.66733795457,11,200,189
80,Pós-Graduação completa,3185,Desenhistas Projetistas De Construção Civil E Arquitetura,4049.7682937662885,71,559,488
80,Pós-Graduação completa,3186,Desenhistas Projetistas Da Mecânica,5300.632411829664,9,553,544
80,Pós-Graduação completa,3187,Desenhistas Projetistas Da Eletrônica,4347.00106201539,-6,149,155
80,Pós-Graduação completa,3188,Desenhistas Projetistas E Modelistas De Produtos E Serviços Diversos,3834.3279708158534,4,338,334
80,Pós-Graduação completa,3191,Técnicos Do Vestuário,5255.65342018821,3,18,15
80,Pós-Graduação completa,3192,Técnicos Do Mobiliário E Afins,1553.0780029296875,1,3,2
80,Pós-Graduação completa,3201,Técnicos Em Biologia,3386.8612065390935,-9,14,23
80,Pós-Graduação completa,3211,Técnicos Agrícolas,4291.727277562239,26,361,335
80,Pós-Graduação completa,3212,Técnicos Florestais,4839.656391116659,-2,128,130
80,Pós-Graduação completa,3213,Técnicos Em Aqüicultura,2093.768351236979,-2,1,3
80,Pós-Graduação completa,3221,Tecnólogos E Técnicos Em Terapias Complementares E Estéticas,5088.7751438151,151,806,655
80,Pós-Graduação completa,3222,Técnicos E Auxiliares De Enfermagem,3296.889411424991,-576,2178,2754
80,Pós-Graduação completa,3223,Técnicos Em Óptica E Optometria,2901.8511747472426,1,9,8
80,Pós-Graduação completa,3224,Técnicos De Odontologia,2435.885810973594,14,198,184
80,Pós-Graduação completa,3225,Técnicos Em Próteses Ortopédicas,5688.306982421875,4,7,3
80,Pós-Graduação completa,3226,Técnicos De Imobilizações Ortopédicas,1908.2162399291992,4,10,6
80,Pós-Graduação completa,3231,Técnicos Em Pecuária,5980.551622178819,-2,8,10
80,Pós-Graduação completa,3241,Tecnólogos E Técnicos Em Métodos De Diagnósticos E Terapêutica,2642.636042294731,44,570,526
80,Pós-Graduação completa,3242,Técnicos De Laboratórios De Saúde E Bancos De Sangue,2562.070620548019,-37,730,767
80,Pós-Graduação completa,3250,"Enólogos, Perfumistas E Aromistas",9243.823751667442,-9,15,24
80,Pós-Graduação completa,3251,Técnico Em Farmácia E Em Manipulação Farmacêutica,2906.0479733512097,-9,124,133
80,Pós-Graduação completa,3252,"Técnicos Em Produção, Conservação  E De Qualidade De Alimentos",3355.133512149264,-9,127,136
80,Pós-Graduação completa,3253,Técnicos De Apoio À Biotecnologia,4144.833050198025,1,9,8
80,Pós-Graduação completa,3281,Técnicos Em Necrópsia E Taxidermistas,2761.285986328125,-1,2,3
80,Pós-Graduação completa,3311,Professores De Nível Médio Na Educação Infantil,2741.2083585718638,774,5349,4575
80,Pós-Graduação completa,3312,Professores De Nível Médio No Ensino Fundamental,3504.260571006272,899,5669,4770
80,Pós-Graduação completa,3313,Professores De Nível Médio No Ensino Profissionalizante,2371.652511364855,-16,679,695
80,Pós-Graduação completa,3321,Professores Leigos No Ensino Fundamental,4415.437521307865,43,265,222
80,Pós-Graduação completa,3322,Professores Práticos No Ensino Profissionalizante,3648.593659045266,44,510,466
80,Pós-Graduação completa,3331,Instrutores E Professores De Cursos Livres,3144.0924045268353,-249,3473,3722
80,Pós-Graduação completa,3341,Inspetores De Alunos E Afins,1833.779928144165,-6,1187,1193
80,Pós-Graduação completa,3411,"Pilotos De Aviação Comercial, Mecânicos De Vôo E Afins",5690.966838374283,19,43,24
80,Pós-Graduação completa,3412,"Técnicos Marítimos, Fluviários E Pescadores De Convés",8904.566436258952,-2,9,11
80,Pós-Graduação completa,3413,Técnicos Marítimos E Fluviários De Máquinas,3510.6479410807287,-6,8,14
80,Pós-Graduação completa,3421,Especialistas Em Logística De Transportes,4760.976676242154,166,2789,2623
80,Pós-Graduação completa,3422,Despachantes Aduaneiros,4511.500979002483,3,97,94
80,Pós-Graduação completa,3423,Técnicos Em Transportes Rodoviários,5041.012799799253,-86,600,686
80,Pós-Graduação completa,3424,Técnicos Em Transportes Metroferroviários,4003.2331550784374,-18,41,59
80,Pós-Graduação completa,3425,Técnicos Em Transportes Aéreos,5583.597955582463,-36,273,309
80,Pós-Graduação completa,3426,Técnicos Em Transportes Por Vias Navegáveis E Operações Portuárias,7479.631109812196,1,145,144
80,Pós-Graduação completa,3511,Técnicos Em Contabilidade,9273.058274019999,-127,823,950
80,Pós-Graduação completa,3513,Técnicos Em Administração,4984.070987868753,-37,1269,1306
80,Pós-Graduação completa,3514,Serventuários Da Justiça E Afins,5060.416714622671,131,1570,1439
80,Pós-Graduação completa,3515,"Técnicos Em Secretariado, Taquígrafos E Estenotipistas",2150.5255908424815,-75,671,746
80,Pós-Graduação completa,3516,Técnicos Em Segurança Do Trabalho,5564.600094055109,-272,4032,4304
80,Pós-Graduação completa,3517,Técnicos De Seguros E Afins,5523.131131041555,68,1636,1568
80,Pós-Graduação completa,3518,Agentes De Investigação E Identificação,8102.720052083333,0,3,3
80,Pós-Graduação completa,3519,Técnicos Da Inteligência,6878.500165666853,1,28,27
80,Pós-Graduação completa,3522,Agentes Da Saúde E Do Meio Ambiente,4692.656487424009,220,1367,1147
80,Pós-Graduação completa,3523,Agentes  Fiscais Metrológicos E De Qualidade,3851.128827794162,-18,212,230
80,Pós-Graduação completa,3524,Profissionais De Direitos Autorais E De Avaliacão De Produtos Dos Meios De Comunicação,4122.626933347143,-5,35,40
80,Pós-Graduação completa,3532,Técnicos Em Operações E Serviços Bancários,5525.384200459049,-262,440,702
80,Pós-Graduação completa,3541,Especialistas Em Promoção De Produtos E Vendas,5508.779786267644,2426,17087,14661
80,Pós-Graduação completa,3542,Compradores,6953.899805041774,484,6708,6224
80,Pós-Graduação completa,3543,Analistas De Comércio Exterior,6826.239428347142,-85,1771,1856
80,Pós-Graduação completa,3544,Leiloeiros E Avaliadores,4080.4398997114513,6,61,55
80,Pós-Graduação completa,3545,Corretores De Seguros,4931.326583862305,5,31,26
80,Pós-Graduação completa,3546,Corretores De Imóveis E De Grãos,4481.151767615116,29,126,97
80,Pós-Graduação completa,3547,Representantes Comerciais Autônomos,5169.171938329711,-10,128,138
80,Pós-Graduação completa,3548,Técnicos Em Serviços De Turismo E Organização De Eventos,3629.8213535631817,-35,1005,1040
80,Pós-Graduação completa,3711,Técnicos Em Biblioteconomia,2957.9273221495177,-53,143,196
80,Pós-Graduação completa,3712,Técnicos Em Museologia E Afins,2535.627780490451,-5,7,12
80,Pós-Graduação completa,3713,Técnicos Em Artes Gráficas,4779.303229254645,-1,26,27
80,Pós-Graduação completa,3714,Recreadores,1662.8281885484257,11,700,689
80,Pós-Graduação completa,3721,Captadores De Imagens Em Movimento,5953.279484954158,11,45,34
80,Pós-Graduação completa,3722,Operadores De Rede De Teleprocessamento E Afins,2911.765721817904,162,513,351
80,Pós-Graduação completa,3731,Técnicos De Operação De Registros Sonoro/Audiovisuais,3863.48209411716,14,179,165
80,Pós-Graduação completa,3732,Supervisores Operacionais E Técnicos Em Mídias Audiovisuais,6657.311244500666,-91,136,227
80,Pós-Graduação completa,3741,Técnicos Em Áudio,8739.25442610501,-9,52,61
80,Pós-Graduação completa,3742,Técnicos Em Cenografia,3044.666477614183,3,31,28
80,Pós-Graduação completa,3743,Técnicos Em Operação De Aparelhos De Projeção,525322.0549926758,0,2,2
80,Pós-Graduação completa,3744,"Técnicos Em Montagem, Edição E Finalização De Mídia Audiovisual",3864.497220283889,48,228,180
80,Pós-Graduação completa,3751,"Designers De Interiores, De Vitrines E Visual Merchandiser E Afins (Nível Médio)",4119.2632144549325,-16,198,214
80,Pós-Graduação completa,3761,Dançarinos Tradicionais E Populares,60481.5,1,2,1
80,Pós-Graduação completa,3762,Artistas De Circo (Circenses),1616.6666666666667,1,2,1
80,Pós-Graduação completa,3763,"Apresentadores De Eventos, Programas E Espetáculos",3180.7567141432983,-7,31,38
80,Pós-Graduação completa,3764,Modelos,3108.330769856771,-3,1,4
80,Pós-Graduação completa,3771,Atletas Profissionais,3208.124788806552,-11,36,47
80,Pós-Graduação completa,3772,Árbitros Desportivos,4101.877278645833,2,11,9
80,Pós-Graduação completa,3911,"Planejadores, Programadores E Controladores De Produção E Manutenção",8227.377585000328,-139,5090,5229
80,Pós-Graduação completa,3912,Técnicos De Controle Da Produção,4538.861099252213,-15,6881,6896
80,Pós-Graduação completa,3951,Técnicos De Apoio Em Pesquisa E Desenvolvimento,7165.176059484329,115,1030,915
80,Pós-Graduação completa,4101,Supervisores Administrativos,7370.737478800699,-1740,13898,15638
80,Pós-Graduação completa,4102,"Supervisores De Serviços Financeiros, De Câmbio E De Controle",7212.452998200432,79,4433,4354
80,Pós-Graduação completa,4110,"Agentes, Assistentes E Auxiliares Administrativos",2649.7536670093677,-1267,52399,53666
80,Pós-Graduação completa,4121,Operadores De Equipamentos De Entrada E Transmissão De Dados,4907.084740859615,-25,271,296
80,Pós-Graduação completa,4122,Contínuos,1844.7309469546913,-38,140,178
80,Pós-Graduação completa,4131,Auxiliares De Contabilidade,3091.3710163860997,-385,9732,10117
80,Pós-Graduação completa,4132,Escriturários De Serviços Bancários,3758.2764293518535,-3767,3998,7765
80,Pós-Graduação completa,4141,Almoxarifes E Armazenistas,2584.528852448394,130,3002,2872
80,Pós-Graduação completa,4142,Apontadores E Conferentes,3715.809057589562,-88,566,654
80,Pós-Graduação completa,4151,"Auxiliares De Serviços De Documentação, Informação E Pesquisa",3156.445401185235,-10,199,209
80,Pós-Graduação completa,4152,"Trabalhadores Nos Serviços De Classificação E Entregas De Correspondências, Encomendas E Publicações",2882.865055072898,-131,29,160
80,Pós-Graduação completa,4153,Trabalhadores Em Registros E Informações Em Saúde,6317.31005859375,1,1,0
80,Pós-Graduação completa,4201,Supervisores De Atendimento Ao Público E De Pesquisa,4695.890102138635,-245,2533,2778
80,Pós-Graduação completa,4211,Caixas E Bilheteiros (Exceto Caixa De Banco),2158.7133759865565,-402,1901,2303
80,Pós-Graduação completa,4212,Coletadores De Apostas E De Jogos,2306.4622936304063,-18,28,46
80,Pós-Graduação completa,4213,Cobradores E Afins,4128.752885333637,-21,784,805
80,Pós-Graduação completa,4221,Recepcionistas,2360.0497117410264,-179,4742,4921
80,Pós-Graduação completa,4222,Operadores De Telefonia,2177.1485508388337,-111,352,463
80,Pós-Graduação completa,4223,Operadores De Telemarketing E Afins,1955.9956617122414,-201,4530,4731
80,Pós-Graduação completa,4231,Despachantes Documentalistas E Afins,2242.8614652752876,1,39,38
80,Pós-Graduação completa,4241,Entrevistadores E Recenseadores,3605.013773767046,27,200,173
80,Pós-Graduação completa,4242,Aplicadores De Provas E Afins,3446.328983653675,-6,10,16
80,Pós-Graduação completa,5101,"Supervisores Dos Serviços De Transporte, Turismo, Hotelaria E Administração De Edifícios",3915.7708187854755,8,483,475
80,Pós-Graduação completa,5102,Supervisores De Lavanderia,4112.707957987883,-5,22,27
80,Pós-Graduação completa,5103,"Supervisores Dos Serviços De Proteção, Segurança E Outros",5867.858416360522,-12,260,272
80,Pós-Graduação completa,5111,Trabalhadores De Segurança E Atendimento Aos Usuários Nos Transportes,2050.7315663572895,14,137,123
80,Pós-Graduação completa,5112,Fiscais E Cobradores Dos Transportes Coletivos,2073.725534243936,-29,82,111
80,Pós-Graduação completa,5114,Guias De Turismo,2311.5917253165408,7,18,11
80,Pós-Graduação completa,5115,Condutores De Turismo,2121.0350036621094,0,2,2
80,Pós-Graduação completa,5121,Trabalhadores Dos Serviços Domésticos Em Geral,1813.538338216146,-1,6,7
80,Pós-Graduação completa,5131,Mordomos E Governantas,3846.545371767074,-2,116,118
80,Pós-Graduação completa,5132,Cozinheiros,2074.2824395288744,40,491,451
80,Pós-Graduação completa,5133,"Camareiros, Roupeiros E Afins",6548.933412712388,-13,27,40
80,Pós-Graduação completa,5134,"Trabalhadores No Atendimento Em Estabelecimentos De Serviços De Alimentação, Bebidas E Hotelaria",2214.9546963324497,6,692,686
80,Pós-Graduação completa,5135,Trabalhadores Auxiliares Nos Serviços De Alimentação,2302.7271374652964,5,359,354
80,Pós-Graduação completa,5136,"Churrasqueiros, Pizzaiolos E Sushimen",1931.2510202844157,5,23,18
80,Pós-Graduação completa,5141,Trabalhadores Nos Serviços De Administração De Edifícios,1725.1025411233136,-10,139,149
80,Pós-Graduação completa,5142,"Trabalhadores Nos Serviços De Coleta De Resíduos, De Limpeza E Conservação De Áreas Públicas",1726.7398520711342,-24,148,172
80,Pós-Graduação completa,5143,Trabalhadores Nos  Serviços De Manutenção De Edificações,2347.234592551751,-18,790,808
80,Pós-Graduação completa,5151,Trabalhadores Em Serviços De Promoção E Apoio À Saúde,2779.800621521533,104,408,304
80,Pós-Graduação completa,5152,Auxiliares De Laboratório Da Saúde,2146.4946295536824,-15,609,624
80,Pós-Graduação completa,5153,"Trabalhadores De Atenção, Defesa E Proteção A Pessoas Em Situação De Risco E Adolescentes Em Conflito Com A Lei",2791.408457335382,137,1274,1137
80,Pós-Graduação completa,5161,Trabalhadores Nos Serviços De Embelezamento E Higiene,1958.6172744415617,-3,21,24
80,Pós-Graduação completa,5162,"Cuidadores De Crianças, Jovens, Adultos E Idosos",2447.5938558153607,-14,422,436
80,Pós-Graduação completa,5163,"Tintureiros, Lavadeiros E Afins, A Máquina",1658.7011783781504,-9,29,38
80,Pós-Graduação completa,5164,"Lavadores E Passadores De Roupa, A Mão",1488.3900146484375,1,1,0
80,Pós-Graduação completa,5165,Trabalhadores Dos Serviços Funerários,1713.9552052815754,0,24,24
80,Pós-Graduação completa,5166,Trabalhadores Auxiliares Dos Serviços Funerários,1416.75,1,1,0
80,Pós-Graduação completa,5168,Esotéricos E Paranormais,1763.1600646972656,-2,0,2
80,Pós-Graduação completa,5169,Trabalhadores Nos Serviços De Arte Corporal,1400,0,1,1
80,Pós-Graduação completa,5171,"Bombeiros, Salva-Vidas E Afins",2586.59133148102,21,134,113
80,Pós-Graduação completa,5172,"Policiais, Guardas-Civis Municipais E Agentes De Trânsito",3278.4305279818445,-18,25,43
80,Pós-Graduação completa,5173,Vigilantes E Guardas De Segurança,2683.667624820209,-46,494,540
80,Pós-Graduação completa,5174,"Porteiros, Vigias E Afins",2195.7001589150777,19,729,710
80,Pós-Graduação completa,5191,Motociclistas E Ciclistas De Entregas Rápidas,2177.9789897808005,0,72,72
80,Pós-Graduação completa,5192,Trabalhadores Da Coleta E Seleção De Material Reciclável,1928.2433420817058,2,9,7
80,Pós-Graduação completa,5193,"Trabalhadores De Serviços Veterinários, De Higiene E Estética De Animais Domésticos",1912.9693523491753,5,65,60
80,Pós-Graduação completa,5199,Outros Trabalhadores Dos Serviços,1923.4159189233112,-6,141,147
80,Pós-Graduação completa,5201,Supervisores De Vendas E De Prestação De Serviços,6159.305307239994,-133,5946,6079
80,Pós-Graduação completa,5211,Operadores Do Comércio Em Lojas E Mercados,2365.693554599079,-82,15607,15689
80,Pós-Graduação completa,5231,Instaladores De Produtos E Acessórios,1787.9361897786457,-2,6,8
80,Pós-Graduação completa,5241,Vendedores Em Domicílio,3969.468781631857,-70,950,1020
80,Pós-Graduação completa,5242,"Vendedores Em Bancas, Quiosques E Barracas",1786.1945486886161,-6,15,21
80,Pós-Graduação completa,5243,Vendedores Ambulantes,1794.1120375029896,-5,22,27
80,Pós-Graduação completa,6110,Produtores Agropecuários Em Geral,1750,0,1,1
80,Pós-Graduação completa,6120,Produtores Agrícolas Polivalentes,2367.3466796875,-1,1,2
80,Pós-Graduação completa,6122,Produtores Agrícolas Na Cultura De Plantas Fibrosas,1836,-1,0,1
80,Pós-Graduação completa,6123,Produtores Agrícolas Na Olericultura,1463.905008951823,0,3,3
80,Pós-Graduação completa,6128,Produtores De Especiarias E De Plantas Aromáticas E Medicinais,2000,-1,0,1
80,Pós-Graduação completa,6132,Produtores Em Pecuária De Animais De Médio Porte,4500,0,1,1
80,Pós-Graduação completa,6201,Supervisores Na Exploração Agropecuária,6758.927941241954,-21,177,198
80,Pós-Graduação completa,6210,Trabalhadores Agropecuários Em Geral,2436.196526421441,22,83,61
80,Pós-Graduação completa,6220,Trabalhadores De Apoio À Agricultura,1893.499796251569,32,166,134
80,Pós-Graduação completa,6221,Trabalhadores Agrícolas Na Cultura De Gramíneas,1539.8989606633097,3,39,36
80,Pós-Graduação completa,6223,Trabalhadores Agrícolas Na Olericultura,2071,0,2,2
80,Pós-Graduação completa,6224,Trabalhadores Agrícolas No Cultivo De Flores E Plantas Ornamentais,1498.2000244140625,2,4,2
80,Pós-Graduação completa,6225,Trabalhadores Agrícolas Na Fruticultura,2403.2882698254707,1,29,28
80,Pós-Graduação completa,6226,Trabalhadores Agrícolas Nas Culturas De Plantas Estimulantes,1169.2394476996528,0,10,10
80,Pós-Graduação completa,6227,Trabalhadores Agrícolas Na Cultura De Plantas Oleaginosas,2164.3084622896636,1,7,6
80,Pós-Graduação completa,6230,Tratadores Polivalentes De Animais,1723.425979598608,0,23,23
80,Pós-Graduação completa,6231,Trabalhadores Na Pecuária De Animais De Grande Porte,2301.2498577216393,-7,43,50
80,Pós-Graduação completa,6232,Trabalhadores Na Pecuária De Animais De Médio Porte,11730.140933990479,1,9,8
80,Pós-Graduação completa,6233,Trabalhadores Na Avicultura E Cunicultura,1972.6827914026937,-4,18,22
80,Pós-Graduação completa,6234,Trabalhadores Na Criação De Insetos E Animais Úteis,1777.6900024414063,0,1,1
80,Pós-Graduação completa,6301,Supervisores Na Área Florestal E Aqüicultura,7574.654009567482,-2,71,73
80,Pós-Graduação completa,6312,Pescadores De Água Costeira E Alto Mar,1543.8625030517578,-4,2,6
80,Pós-Graduação completa,6313,Criadores De Animais Aquáticos,3456.8701171875,1,1,0
80,Pós-Graduação completa,6314,Trabalhadores De Apoio À Pesca,1014.72998046875,-2,0,2
80,Pós-Graduação completa,6320,Trabalhadores Florestais Polivalentes,2358.2877739800347,-3,4,7
80,Pós-Graduação completa,6321,Extrativistas E Reflorestadores De Espécies Produtoras De Madeira,2243.456043590199,-3,10,13
80,Pós-Graduação completa,6322,Extrativistas Florestais De Espécies Produtoras De Gomas E Resinas,1455,0,1,1
80,Pós-Graduação completa,6410,Trabalhadores Da Mecanização Agrícola,2560.661619783268,5,63,58
80,Pós-Graduação completa,6420,Trabalhadores Da Mecanização Florestal,2353.6317162533355,78,129,51
80,Pós-Graduação completa,6430,Trabalhadores Da Irrigação E Drenagem,2482.562493218316,2,7,5
80,Pós-Graduação completa,7101,Supervisores Da Extração Mineral,10958.273311423914,78,246,168
80,Pós-Graduação completa,7102,Supervisores Da Construção Civil,4491.512030705715,-19,395,414
80,Pós-Graduação completa,7111,Trabalhadores Da Extração De Minerais Sólidos,3158.3618774414063,-2,11,13
80,Pós-Graduação completa,7112,Trabalhadores De Extração De Minerais Sólidos (Operadores De Máquinas),2875.9504457131416,-4,10,14
80,Pós-Graduação completa,7113,Trabalhadores Da Extração De Minerais Líquidos E Gasosos,5363.127085783987,1,22,21
80,Pós-Graduação completa,7121,Trabalhadores De Beneficiamento De Minérios,2798.577990722656,-4,1,5
80,Pós-Graduação completa,7122,Trabalhadores De Beneficiamento De Pedras Ornamentais,1497.7693277994792,-4,4,8
80,Pós-Graduação completa,7151,Trabalhadores Na Operação De Máquinas De Terraplenagem E Fundações,2304.6937226266573,21,73,52
80,Pós-Graduação completa,7152,Trabalhadores De Estruturas De Alvenaria,2990.4046020507813,3,86,83
80,Pós-Graduação completa,7153,Montadores De Estruturas De Concreto Armado,1893.1468135949335,1,9,8
80,Pós-Graduação completa,7154,Trabalhadores Na Operação De Máquinas De Concreto Usinado E Afins,2081.6547785683283,2,17,15
80,Pós-Graduação completa,7155,"Trabalhadores De Montagem De Estruturas De Madeira, Metal E Compósitos Em Obras Civis",2270.911965321079,3,32,29
80,Pós-Graduação completa,7156,Trabalhadores De Instalações Elétricas,4039.774130633038,-26,125,151
80,Pós-Graduação completa,7157,Aplicadores De Materiais Isolantes,2722.9525451660156,-2,1,3
80,Pós-Graduação completa,7163,Vidraceiros (Revestimentos Rígidos),1836.5633273654514,0,9,9
80,Pós-Graduação completa,7164,Gesseiros,1713.5659912109375,2,6,4
80,Pós-Graduação completa,7165,"Aplicadores De Revestimentos Cerâmicos, Pastilhas, Pedras E Madeiras",1934.9527621799045,-4,7,11
80,Pós-Graduação completa,7166,Pintores De Obras E Revestidores De Interiores (Revestimentos Flexíveis),4044.288839901195,0,17,17
80,Pós-Graduação completa,7170,Ajudantes De Obras Civis,1599.8204167179615,5,183,178
80,Pós-Graduação completa,7201,"Supervisores De Usinagem, Conformação E Tratamento De Metais",7356.180256434835,-24,134,158
80,Pós-Graduação completa,7202,Supervisores Da Fabricação E Montagem Metalmecânica,12469.615753944778,-89,245,334
80,Pós-Graduação completa,7211,Ferramenteiros E Afins,8457.713252288218,-14,47,61
80,Pós-Graduação completa,7212,Preparadores E Operadores De Máquinas-Ferramenta Convencionais,3665.689365620217,-15,92,107
80,Pós-Graduação completa,7213,Afiadores E Polidores De Metais,3273.2840567452567,-1,8,9
80,Pós-Graduação completa,7214,Operadores De Máquinas De Usinagem Cnc,12165.193436157724,-2,64,66
80,Pós-Graduação completa,7221,Trabalhadores De Forjamento De Metais,3109.6796468098955,0,4,4
80,Pós-Graduação completa,7222,Trabalhadores De Fundição De Metais Puros E De Ligas Metálicas,2442.9960171501143,-8,12,20
80,Pós-Graduação completa,7223,Trabalhadores De Moldagem De Metais E De Ligas Metálicas,2841.0533040364585,-5,1,6
80,Pós-Graduação completa,7224,Trabalhadores De Trefilação E Estiramento De Metais Puros E Ligas Metálicas,3342.5899353027344,0,4,4
80,Pós-Graduação completa,7231,Trabalhadores De Tratamento Térmico De Metais,2046.3890014648437,2,5,3
80,Pós-Graduação completa,7232,Trabalhadores De Tratamento De Superfícies De Metais E De Compósitos (Termoquímicos),3406.233896891276,3,6,3
80,Pós-Graduação completa,7233,"Trabalhadores Da Pintura De Equipamentos, Veículos, Estruturas Metálicas E De Compósitos",2765.675116426414,-7,21,28
80,Pós-Graduação completa,7241,Encanadores E Instaladores De Tubulações,3001.1972064652537,-10,45,55
80,Pós-Graduação completa,7242,Trabalhadores De Traçagem E Montagem De Estruturas Metálicas E De Compósitos,3415.7234442875306,-4,38,42
80,Pós-Graduação completa,7243,Trabalhadores De Soldagem E Corte De Ligas Metálicas,3038.7052469779546,-9,73,82
80,Pós-Graduação completa,7244,Trabalhadores De Caldeiraria E Serralheria,2361.7999911382394,5,54,49
80,Pós-Graduação completa,7245,Operadores De Máquinas De Conformação De Metais,39193.52125990126,1,16,15
80,Pós-Graduação completa,7246,Trançadores E Laceiros De Cabos De Aço,2049.199951171875,-1,0,1
80,Pós-Graduação completa,7250,Ajustadores Mecânicos Polivalentes E Afins,2822.866468641493,4,33,29
80,Pós-Graduação completa,7251,"Montadores De Máquinas, Aparelhos E Acessórios Em Linhas De Montagem",2702.6148851971293,-9,17,26
80,Pós-Graduação completa,7252,Montadores De Máquinas Industriais,3831.209153980481,1,55,54
80,Pós-Graduação completa,7253,Montadores De Máquinas Pesadas E Equipamentos Agrícolas,2256.578589545356,-4,12,16
80,Pós-Graduação completa,7254,Mecânicos Montadores De Motores E Turboalimentadores,2313.835009765625,1,10,9
80,Pós-Graduação completa,7255,Montadores De Veículos Automotores (Linha De Montagem),3186.4455283672387,21,81,60
80,Pós-Graduação completa,7256,Montadores De Sistemas E Estruturas De Aeronaves,3630.3,3,4,1
80,Pós-Graduação completa,7257,Instaladores De Equipamentos De Refrigeração E Ventilação,2867.3999837239585,-1,13,14
80,Pós-Graduação completa,7301,Supervisores De Montagens E Instalações Eletroeletrônicas,16947.230354178377,-47,174,221
80,Pós-Graduação completa,7311,Montadores De Equipamentos Eletroeletrônicos,5213.994635458153,-26,103,129
80,Pós-Graduação completa,7312,Montadores De Aparelhos De Telecomunicações,3754.0899658203125,-4,1,5
80,Pós-Graduação completa,7313,Instaladores-Reparadores De  Linhas E Equipamentos De Telecomunicações,2932.03664398549,-24,31,55
80,Pós-Graduação completa,7321,"Instaladores E Reparadores De Linhas E Cabos Elétricos, Telefônicos E De Comunicação De Dados",2522.6286492376653,-2,135,137
80,Pós-Graduação completa,7401,Supervisores Da Mecânica De Precisão E Instrumentos Musicais,7374.93251953125,0,10,10
80,Pós-Graduação completa,7411,Mecânicos De Instrumentos De Precisão,3801.255043029785,-10,4,14
80,Pós-Graduação completa,7502,"Supervisores De Vidraria, Cerâmica E Afins",7020.479561941965,-4,19,23
80,Pós-Graduação completa,7510,Joalheiros E Lapidadores De Gemas,1851.5,0,2,2
80,Pós-Graduação completa,7511,Artesãos De Metais Preciosos E Semi-Preciosos,2037.2866617838542,3,5,2
80,Pós-Graduação completa,7522,Trabalhadores Da Transformação De Vidros Planos,1989.7033284505208,0,2,2
80,Pós-Graduação completa,7523,Ceramistas (Preparação E Fabricação),3585.997210693359,-8,10,18
80,Pós-Graduação completa,7524,Vidreiros E Ceramistas (Arte E Decoração),3498.14990234375,-1,0,1
80,Pós-Graduação completa,7601,Supervisores Da Indústria Têxtil,6041.31445211668,-15,57,72
80,Pós-Graduação completa,7602,Supervisores Na Indústria Do Curtimento,4980.02490234375,-2,0,2
80,Pós-Graduação completa,7603,Supervisores Na Confecção Do Vestuário,4628.0255768922,6,52,46
80,Pós-Graduação completa,7604,Supervisores Na Confecção De Calçados,18716.74043661089,-23,22,45
80,Pós-Graduação completa,7605,"Supervisores Da Confecção De Artefatos De Tecidos, Couros E Afins",5988.20478515625,-4,23,27
80,Pós-Graduação completa,7606,Supervisores Das Artes Gráficas,7165.322500447281,-13,59,72
80,Pós-Graduação completa,7610,Trabalhadores Polivalentes Das Indústrias Têxteis,1499.6812982973845,-1,11,12
80,Pós-Graduação completa,7611,Trabalhadores Da Classificação De Fibras Têxteis E Lavagem De Lã,1638.135707310268,-1,3,4
80,Pós-Graduação completa,7612,Operadores Da Fiação,1555.3750305175781,-1,2,3
80,Pós-Graduação completa,7613,Operadores De Tear E Máquinas Similares,2385.4994210379464,-5,6,11
80,Pós-Graduação completa,7614,"Trabalhadores De Acabamento, Tingimento E Estamparia Das Indústrias Têxteis",3340.411669108073,0,9,9
80,Pós-Graduação completa,7618,Inspetores E Revisores De Produção Têxtil,1562.2300136236497,3,17,14
80,Pós-Graduação completa,7620,Trabalhadores Polivalentes Do Curtimento De Couros E Peles,3274.78515625,0,1,1
80,Pós-Graduação completa,7621,Trabalhadores Da Preparação Do Curtimento De Couros E Peles,2500,1,1,0
80,Pós-Graduação completa,7623,Trabalhadores Do Acabamento De Couros E Peles,1142.75,0,2,2
80,Pós-Graduação completa,7630,Profissionais Polivalentes Da Confecção De Roupas,5438.381660162884,-18,48,66
80,Pós-Graduação completa,7631,Trabalhadores Da Preparação Da Confecção De Roupas,1782.5521931146443,-6,66,72
80,Pós-Graduação completa,7632,Operadores De Máquinas Para Costura De Peças Do Vestuário,1580.2426949120927,-8,111,119
80,Pós-Graduação completa,7633,Operadores De Máquinas Para Bordado E Acabamento De Roupas,1570.6466666666665,-4,15,19
80,Pós-Graduação completa,7640,Trabalhadores Polivalentes Da Confecção De Calçados,1291.0082523406497,9,36,27
80,Pós-Graduação completa,7641,Trabalhadores Da Preparação Da Confecção De Calçados,1322.243916102818,0,16,16
80,Pós-Graduação completa,7642,Operadores De Máquinas De Costurar E Montar Calçados,1737.4643615722657,5,12,7
80,Pós-Graduação completa,7643,Trabalhadores De Acabamento De Calçados,2623.97807429387,9,18,9
80,Pós-Graduação completa,7650,Trabalhadores Polivalentes Da Confecção De Artefatos De Tecidos E Couros,1757.9349975585938,-1,1,2
80,Pós-Graduação completa,7651,"Trabalhadores Da Preparação De Artefatos De Tecidos, Couros E Tapeçaria",1664.5875244140625,0,2,2
80,Pós-Graduação completa,7652,"Trabalhadores Da Confecção De Artefatos De Tecidos, Couros E Sintéticos",1950.874073375355,0,7,7
80,Pós-Graduação completa,7653,Operadores De Máquinas Na Confecção De Artefatos De  Couro,1966,-1,0,1
80,Pós-Graduação completa,7661,Trabalhadores Da Pré-Impressão Gráfica,3444.132513742553,-21,232,253
80,Pós-Graduação completa,7662,Trabalhadores Da Impressão Gráfica,3713.806373466283,-10,23,33
80,Pós-Graduação completa,7663,Trabalhadores Do Acabamento Gráfico,2384.779075113932,-10,14,24
80,Pós-Graduação completa,7664,Trabalhadores De Laboratório Fotográfico E Radiológico,3020.6365302191844,-12,8,20
80,Pós-Graduação completa,7682,Trabalhadores Artesanais Da Confecção De Peças E Tecidos,1405.719970703125,1,2,1
80,Pós-Graduação completa,7683,Trabalhadores Artesanais Da Confecção De Calçados E Artefatos De Couros E Peles,1868.0321146647134,-2,4,6
80,Pós-Graduação completa,7686,Trabalhadores Tipográficos Linotipistas E Afins,2164.9649658203125,-2,0,2
80,Pós-Graduação completa,7701,"Supervisores Em Indústria De Madeira, Mobiliário E Da Carpintaria Veicular",5066.671476636614,-5,54,59
80,Pós-Graduação completa,7711,Marceneiros E Afins,1880.768655313028,-2,18,20
80,Pós-Graduação completa,7721,Trabalhadores De Tratamento E Preparação Da Madeira,1656.7997165256077,-1,7,8
80,Pós-Graduação completa,7731,Operadores De Máquinas De Desdobramento Da Madeira,1679.2419921875,-1,3,4
80,Pós-Graduação completa,7732,Operadores De Máquinas De Aglomeração E Prensagem De Chapas,3792.782501220703,-1,1,2
80,Pós-Graduação completa,7733,Operadores De Usinagem Convencional De Madeira,2211.1824951171875,2,7,5
80,Pós-Graduação completa,7734,Operadores De Máquina De Usinar Madeira (Produção Em Série),1393.5499877929688,0,1,1
80,Pós-Graduação completa,7735,Operadores De Máquinas De Usinagem De Madeira Cnc,2177.870035807292,-3,2,5
80,Pós-Graduação completa,7741,Montadores De Móveis E Artefatos De Madeira,1751.8709319358647,-1,21,22
80,Pós-Graduação completa,7751,Trabalhadores De Arte E  Do Acabamento Em Madeira Do Mobiliário,3334.854736328125,-1,5,6
80,Pós-Graduação completa,7764,"Confeccionadores De Artefatos De Madeira, Móveis De Vime E Afins",1360.469970703125,-1,1,2
80,Pós-Graduação completa,7801,Supervisores De Trabalhadores De Embalagem E Etiquetagem,7354.426357014974,-8,26,34
80,Pós-Graduação completa,7811,Condutores De Processos Robotizados,4799.274973551432,-5,3,8
80,Pós-Graduação completa,7813,Operadores De Equipamentos Pilotados Remotamente,4455.788499024969,19,44,25
80,Pós-Graduação completa,7817,Trabalhadores Subaquáticos,3968.8912658691406,0,4,4
80,Pós-Graduação completa,7821,Operadores De Máquinas E Equipamentos De Elevação,3892.6282489802566,8,23,15
80,Pós-Graduação completa,7822,Operadores De Equipamentos De Movimentação De Cargas,2098.233860752174,-5,95,100
80,Pós-Graduação completa,7823,Motoristas De Veículos De Pequeno E Médio Porte,1977.6468135015027,-13,272,285
80,Pós-Graduação completa,7824,"Motoristas De Ônibus Urbanos, Metropolitanos E Rodoviários",4052.1519480501775,24,166,142
80,Pós-Graduação completa,7825,Motoristas De Veículos De Cargas Em Geral,1848.1311609945253,13,341,328
80,Pós-Graduação completa,7826,Operadores De Veículos Sobre Trilhos E Cabos Aéreos,3486.159668360001,-9,16,25
80,Pós-Graduação completa,7827,Trabalhadores Aquaviários,5851.2264024522565,11,39,28
80,Pós-Graduação completa,7831,Trabalhadores De Manobras De Transportes Sobre Trilhos,2433.066107855903,0,11,11
80,Pós-Graduação completa,7832,Trabalhadores De Cargas E Descargas De Mercadorias,2475.8107838231467,43,324,281
80,Pós-Graduação completa,7841,Trabalhadores De Embalagem E De Etiquetagem,17114.514659889344,22,174,152
80,Pós-Graduação completa,7842,Alimentadores De Linhas De Produção,1966.6777393966179,-28,999,1027
80,Pós-Graduação completa,7911,Artesãos,1430.0808308919272,0,3,3
80,Pós-Graduação completa,8101,"Supervisores De Produção Em Indústrias Químicas, Petroquímicas E Afins",8589.77509243214,-13,189,202
80,Pós-Graduação completa,8102,Supervisores De Produção Em Indústrias De Transformação De Plásticos E Borrachas,7235.00718336839,-18,108,126
80,Pós-Graduação completa,8103,"Supervisores De Produção Em Indústrias De Produtos Farmacêuticos, Cosméticos E Afins",8705.902072105879,-22,151,173
80,Pós-Graduação completa,8110,"Operadores Polivalentes De Equipamentos Em Indústrias Químicas, Petroquímicas E Afins",5727.082232811337,-5,27,32
80,Pós-Graduação completa,8111,Operadores De Equipamentos De Moagem E Mistura De Materiais (Tratamentos Químicos E Afins),1950.469034830729,-7,6,13
80,Pós-Graduação completa,8112,Operadores De Calcinação E De Tratamentos Químicos De Materiais Radioativos,5275.044921875,2,4,2
80,Pós-Graduação completa,8113,Operadores De Equipamentos De Filtragem E Separação,3936.568359853707,-124,24,148
80,Pós-Graduação completa,8114,"Operadores De Equipamentos De Destilação, Evaporação E Reação",3925.924673316592,-4,8,12
80,Pós-Graduação completa,8115,Operadores De Equipamentos De Produção E Refino De Petróleo E Gás,5105.614758300781,-2,6,8
80,Pós-Graduação completa,8116,Operadores De Equipamentos De Coqueificação,2964.820655153509,2,12,10
80,Pós-Graduação completa,8117,"Operadores De Instalações E Máquinas De Produtos Plásticos, De Borracha E Moldadores De Parafinas",4013.926267182781,-8,34,42
80,Pós-Graduação completa,8118,"Operadores De Máquinas E Instalações De Produtos Farmacêuticos, Cosméticos E Afins",2620.695852007185,12,43,31
80,Pós-Graduação completa,8131,"Operadores De Processos Das Indústrias De Transformação De Produtos Químicos, Petroquímicos E Afins",3745.4620709272263,6,169,163
80,Pós-Graduação completa,8181,Laboratoristas Industriais Auxiliares,2648.076918366314,-14,307,321
80,Pós-Graduação completa,8201,Supervisores De Produção Em Indústrias Siderúrgicas,8440.928060846014,0,82,82
80,Pós-Graduação completa,8202,Supervisores Na Fabricação De Materiais Para Construção (Vidros E Cerâmicas),8061.254918866649,-25,40,65
80,Pós-Graduação completa,8211,Operadores De Instalações De Sinterização,2972.7409721823296,3,19,16
80,Pós-Graduação completa,8212,Operadores De Fornos De Primeira  Fusão E Aciaria,3529.6484196980796,-8,5,13
80,Pós-Graduação completa,8213,Operadores De Equipamentos De Laminação,3511.164990234375,-2,2,4
80,Pós-Graduação completa,8214,Operadores De Equipamentos De Acabamento De Chapas E Metais,3951.735626637251,0,104,104
80,Pós-Graduação completa,8221,Forneiros Metalúrgicos (Segunda Fusão E Reaquecimento),6666.0919921875,-1,2,3
80,Pós-Graduação completa,8231,"Operadores Na Preparação De Massas Para Abrasivo, Vidro, Cerâmica, Porcelana E Materiais De Construção",2412.9100341796875,-2,0,2
80,Pós-Graduação completa,8232,"Operadores De Equipamentos De Fabricação  E Beneficiamento De Cristais, Vidros, Cerâmicas, Porcelanas, Fibras De Vidro, Abrasivos E Afins",4796.204734802246,3,12,9
80,Pós-Graduação completa,8233,Operadores De Instalações E Equipamentos De Fabricação De Materiais De Construção,2052.86499226888,1,6,5
80,Pós-Graduação completa,8281,Trabalhadores Da Fabricação De Cerâmica Estrutural Para Construção,1604.3849792480469,0,3,3
80,Pós-Graduação completa,8301,Supervisores Da Fabricação De Celulose E Papel,8301.130534913806,2,37,35
80,Pós-Graduação completa,8311,Preparadores De Pasta Para Fabricação De Papel,4690.263253348215,-6,3,9
80,Pós-Graduação completa,8321,Operadores De Máquinas De Fabricar Papel E Papelão,4051.7353442428457,-6,10,16
80,Pós-Graduação completa,8331,Operadores De Máquinas Na Fabricação De Produtos De Papel E Papelão,2144.259979248047,0,5,5
80,Pós-Graduação completa,8332,Trabalhadores Artesanais De Produtos De Papel E Papelão,941.236650466919,1,2,1
80,Pós-Graduação completa,8401,"Supervisores Da Fabricação De Alimentos, Bebidas E Fumo",6467.362693022151,-27,577,604
80,Pós-Graduação completa,8411,"Trabalhadores Da Indústria De Beneficiamento De Grãos, Cereais E Afins",6674.285903468276,-4,5,9
80,Pós-Graduação completa,8413,Trabalhadores Na Fabricação E Refino De Açúcar,4806.572577089252,-5,6,11
80,Pós-Graduação completa,8414,Trabalhadores Na Fabricação E Conservação De Alimentos,2213.954253511455,-9,40,49
80,Pós-Graduação completa,8415,Trabalhadores Na Pasteurização Do Leite E Na Fabricação De Laticínios  E Afins,2422.462832322761,11,39,28
80,Pós-Graduação completa,8416,"Trabalhadores Na Industrialização De Café, Cacau, Mate E De Produtos Afins",2020.844970703125,-1,1,2
80,Pós-Graduação completa,8417,"Trabalhadores Na Fabricação De Cachaça, Cerveja, Vinhos E Outras Bebidas",4981.761612525353,3,21,18
80,Pós-Graduação completa,8418,"Operadores De Equipamentos Na Fabricação De Pães, Massas Alimentícias, Doces, Chocolates E Achocolatados",2401.8616959009414,-11,11,22
80,Pós-Graduação completa,8421,Cigarreiros E Beneficiadores De Fumo,4251.868740962102,1,12,11
80,Pós-Graduação completa,8481,Trabalhadores Artesanais Na Conservação De Alimentos,1831.221329752604,-3,6,9
80,Pós-Graduação completa,8482,Trabalhadores Artesanais Na Pasteurização Do Leite E Na Fabricação De Laticínios E Afins,1885.3200160435267,-3,2,5
80,Pós-Graduação completa,8483,"Padeiros, Confeiteiros E Afins",1870.1720557705244,-20,150,170
80,Pós-Graduação completa,8484,Trabalhadores Na Degustação E Classificação De Grãos E Afins,2741.5440687567643,-1,33,34
80,Pós-Graduação completa,8485,Magarefes E Afins,2047.6952354011596,-23,148,171
80,Pós-Graduação completa,8486,Trabalhadores Artesanais Na Indústria Do Fumo,1410.199951171875,-1,0,1
80,Pós-Graduação completa,8601,Supervisores Da Produção De Utilidades,8013.452797004633,30,289,259
80,Pós-Graduação completa,8611,"Operadores De Instalações De Geração E Distribuição De Energia Elétrica, Hidráulica, Térmica Ou Nuclear",5035.289404531625,-9,17,26
80,Pós-Graduação completa,8612,Operadores De Instalações De Distribuição De Energia Elétrica,5570.478059895833,-1,7,8
80,Pós-Graduação completa,8621,Operadores De Máquinas A Vapor E Utilidades,3081.7669939369016,-28,119,147
80,Pós-Graduação completa,8622,"Operadores De Instalações De Captação, Tratamento E Distribuição De Água",2897.488965156751,-22,28,50
80,Pós-Graduação completa,8623,Operadores De Instalações De Captação E Esgotos,3095.3424572191743,-3,84,87
80,Pós-Graduação completa,8624,"Operadores De Instalações De Extração, Processamento, Envasamento E Distribuição De Gases",1701.7524820963542,-2,5,7
80,Pós-Graduação completa,8625,Operadores De Instalações De Refrigeração E Ar-Condicionado,2626.6666259765625,-3,1,4
80,Pós-Graduação completa,9101,"Supervisores Em Serviços De Reparação E Manutenção De Máquinas E Equipamentos Industriais, Comerciais E Residenciais",8567.51321265002,-14,546,560
80,Pós-Graduação completa,9102,Supervisores Em Serviços De Reparação E Manutenção Veicular,6339.0221478417625,44,197,153
80,Pós-Graduação completa,9109,"Supervisores De Outros Trabalhadores De Serviços De Reparação, Conservação E Manutenção",9582.145887586805,7,23,16
80,Pós-Graduação completa,9111,"Mecânicos De Manutenção De Bombas, Motores, Compressores E Equipamentos De Transmissão",4396.751393474598,-16,9,25
80,Pós-Graduação completa,9112,Mecânicos De Manutenção E Instalação De Aparelhos De  Climatização E Refrigeração,3759.9843717008025,-13,12,25
80,Pós-Graduação completa,9113,Mecânicos De Manutenção De Máquinas Industriais,3394.787265890273,-3,379,382
80,Pós-Graduação completa,9131,Mecânicos De Manutenção De Máquinas Pesadas E Equipamentos Agrícolas,4289.027185228136,-13,22,35
80,Pós-Graduação completa,9141,Mecânicos De Manutenção Aeronáutica,4839.743208904656,13,58,45
80,Pós-Graduação completa,9142,Mecânicos De Manutenção De Motores E Equipamentos Navais,8349.916666666666,1,2,1
80,Pós-Graduação completa,9143,Mecânicos De Manutenção Metroferroviária,2556.9246544471152,1,7,6
80,Pós-Graduação completa,9144,Mecânicos De Manutenção De Veículos Automotores,3369.200652424518,-11,98,109
80,Pós-Graduação completa,9151,Técnicos Em Manutenção E Reparação De Instrumentos De Medição E Precisão,3477.9588730126097,-12,23,35
80,Pós-Graduação completa,9153,Técnicos Em Manutenção E Reparação De Equipamentos Biomédicos,4423.593669921875,11,68,57
80,Pós-Graduação completa,9154,Reparadores De Equipamentos Fotográficos,6030.18017578125,-1,0,1
80,Pós-Graduação completa,9191,Lubrificadores,2915.5472673069344,-7,13,20
80,Pós-Graduação completa,9192,"Trabalhadores De Manutenção De Roçadeiras, Motoserras E Similares",3125.3996240234374,-3,11,14
80,Pós-Graduação completa,9193,Mecânicos De Manutenção De Bicicletas E Equipamentos Esportivos E De Ginástica,1923.9734264555434,2,7,5
80,Pós-Graduação completa,9501,"Supervisores De Manutenção Eletroeletrônica Industrial, Comercial E Predial",7505.340955300355,-10,331,341
80,Pós-Graduação completa,9502,Supervisores De Manutenção Eletroeletrônica Veicular,5506.413548060826,-2,6,8
80,Pós-Graduação completa,9503,Supervisores De Manutenção Eletromecânica,15443.602959153293,41,455,414
80,Pós-Graduação completa,9511,Eletricistas De Manutenção Eletroeletrônica,4747.384868509409,-47,231,278
80,Pós-Graduação completa,9513,Instaladores E Mantenedores De Sistemas Eletroeletrônicos De Segurança,2364.1289971884744,1,119,118
80,Pós-Graduação completa,9531,"Eletricistas Eletrônicos De Manutenção Veicular (Aérea, Terrestre E Naval)",3124.89946047936,-1,17,18
80,Pós-Graduação completa,9541,"Instaladores E Mantenedores Eletromecânicos De Elevadores, Escadas E Portas Automáticas",3638.4302051156405,8,67,59
80,Pós-Graduação completa,9542,Reparadores De Aparelhos Eletrodomésticos,1043.0116802851358,-4,2,6
80,Pós-Graduação completa,9543,Reparadores De Equipamentos De Escritório,2574.9649963378906,-2,3,5
80,Pós-Graduação completa,9911,Conservadores De Vias Permanentes (Trilhos),2275.816972520616,1,6,5
80,Pós-Graduação completa,9912,Mantenedores De Equipamentos De Parques De Diversões E Similares,1584,1,1,0
80,Pós-Graduação completa,9913,Reparadores De Carrocerias De Veículos,2194.0592244466147,-2,8,10
80,Pós-Graduação completa,9921,Trabalhadores Elementares De Serviços De Manutenção Veicular,3575.9292849027192,-5,8,13
80,Pós-Graduação completa,9922,Trabalhadores Operacionais De Conservação De Vias Permanentes (Exceto Trilhos),2549.9047944596277,-18,74,92
99,Não identificado,1232,Diretores De Recursos Humanos E Relações De Trabalho,14123.48046875,-2,0,2
99,Não identificado,1311,"Diretores E Gerentes De Operações Em Empresa De Serviços Pessoais, Sociais E Culturais",67801.5,-1,0,1
99,Não identificado,1312,"Gestores E Especialistas De Operações Em Empresas, Secretarias E Unidades De Serviços De Saúde",23731.980346679688,-2,0,2
99,Não identificado,1416,"Gerentes De Operações De Serviços Em Empresa De Transporte, De Comunicação E De Logística (Armazenagem E Distribuição)",4746,-1,0,1
99,Não identificado,1417,Gerentes De Operações De Serviços Em Instituição De Intermediação Financeira,7556.385009765625,-2,0,2
99,Não identificado,1421,"Gerentes Administrativos, Financeiros, De Riscos E Afins",23805.345703125,-2,0,2
99,Não identificado,1422,Gerentes De Recursos Humanos E De Relações Do Trabalho,19064.9599609375,-2,0,2
99,Não identificado,1423,"Gerentes De Comercialização, Marketing E Comunicação",8249.049499511719,-5,1,6
99,Não identificado,1424,Gerentes De Suprimentos E Afins,2000,-1,0,1
99,Não identificado,1426,Gerentes De Pesquisa E Desenvolvimento E Afins,1673.75,-1,0,1
99,Não identificado,2124,Analistas De Tecnologia Da Informação,12386.965087890625,-3,0,3
99,Não identificado,2142,Engenheiros Civis E Afins,10000.33984375,-1,0,1
99,Não identificado,2212,Biomédicos,3808.989990234375,-1,0,1
99,Não identificado,2234,Farmacêuticos,4636.544921875,0,1,1
99,Não identificado,2235,Enfermeiros E Afins,4933.9021484375,-5,0,5
99,Não identificado,2236,Fisioterapeutas,5230.705078125,-2,0,2
99,Não identificado,2311,Professores De Nível Superior Na Educação Infantil,1058.8249816894531,-4,0,4
99,Não identificado,2312,Professores De Nível Superior Do Ensino Fundamental (Primeira A Quarta Séries),145.69500350952148,-4,0,4
99,Não identificado,2341,"Professores De Matemática, Estatística E Informática Do Ensino Superior",3740.56005859375,-1,0,1
99,Não identificado,2345,Professores Na Área De Formação Pedagógica Do Ensino Superior,1953.9741439819336,-12,0,12
99,Não identificado,2347,Professores De Ciências Humanas Do Ensino Superior,3085.320068359375,-1,0,1
99,Não identificado,2394,"Programadores, Avaliadores E Orientadores De Ensino",2818,-2,0,2
99,Não identificado,2515,Psicólogos E Psicanalistas,2050,-1,0,1
99,Não identificado,2516,Assistentes Sociais E Economistas Domésticos,2700,-1,0,1
99,Não identificado,2521,Administradores,7468.037890625,-5,0,5
99,Não identificado,2522,Contadores E Afins,3343.842529296875,-4,0,4
99,Não identificado,2524,Profissionais De Recursos Humanos,3204.4649658203125,-6,0,6
99,Não identificado,2525,Profissionais De Administração Ecônomico-Financeira,2967.260009765625,-1,1,2
99,Não identificado,2527,"Profissionais De Planejamento, Programação E Controles Logisticos",2000,-1,0,1
99,Não identificado,2531,Profissionais De Publicidade,2937.429931640625,-1,0,1
99,Não identificado,2611,Profissionais Do Jornalismo,3238.050048828125,-1,0,1
99,Não identificado,2612,Profissionais Da Informação,3697.949951171875,-1,0,1
99,Não identificado,2621,Produtores Artísticos E Culturais,3546,-2,0,2
99,Não identificado,3132,Técnicos Em Eletrônica,2085.60009765625,-1,0,1
99,Não identificado,3311,Professores De Nível Médio Na Educação Infantil,2100,-4,0,4
99,Não identificado,3341,Inspetores De Alunos E Afins,1740,-1,0,1
99,Não identificado,3511,Técnicos Em Contabilidade,2221.199951171875,-1,0,1
99,Não identificado,3514,Serventuários Da Justiça E Afins,5425,2,2,0
99,Não identificado,3541,Especialistas Em Promoção De Produtos E Vendas,4466.235046386719,-1,1,2
99,Não identificado,3731,Técnicos De Operação De Registros Sonoro/Audiovisuais,0,-1,0,1
99,Não identificado,3771,Atletas Profissionais,3720,2,3,1
99,Não identificado,3951,Técnicos De Apoio Em Pesquisa E Desenvolvimento,4634.1201171875,-1,0,1
99,Não identificado,4101,Supervisores Administrativos,2423.9599609375,-1,0,1
99,Não identificado,4102,"Supervisores De Serviços Financeiros, De Câmbio E De Controle",4599.4599609375,-1,0,1
99,Não identificado,4110,"Agentes, Assistentes E Auxiliares Administrativos",1607.099131750682,-13,1,14
99,Não identificado,4122,Contínuos,1136,-1,0,1
99,Não identificado,4131,Auxiliares De Contabilidade,1736.889990234375,-5,0,5
99,Não identificado,4141,Almoxarifes E Armazenistas,1643.2941826714411,-1,4,5
99,Não identificado,4152,"Trabalhadores Nos Serviços De Classificação E Entregas De Correspondências, Encomendas E Publicações",1450,1,1,0
99,Não identificado,4201,Supervisores De Atendimento Ao Público E De Pesquisa,2249.820068359375,-1,0,1
99,Não identificado,4211,Caixas E Bilheteiros (Exceto Caixa De Banco),1636.1033257378472,-1,4,5
99,Não identificado,4213,Cobradores E Afins,1958,1,1,0
99,Não identificado,4221,Recepcionistas,1810.2242867606028,-2,3,5
99,Não identificado,4223,Operadores De Telemarketing E Afins,1329.0844590928818,-3,1,4
99,Não identificado,5103,"Supervisores Dos Serviços De Proteção, Segurança E Outros",2244,1,1,0
99,Não identificado,5132,Cozinheiros,1746.094970703125,-1,3,4
99,Não identificado,5134,"Trabalhadores No Atendimento Em Estabelecimentos De Serviços De Alimentação, Bebidas E Hotelaria",1511.477599404075,-5,7,12
99,Não identificado,5135,Trabalhadores Auxiliares Nos Serviços De Alimentação,1599.7933349609375,-3,0,3
99,Não identificado,5136,"Churrasqueiros, Pizzaiolos E Sushimen",2500,1,1,0
99,Não identificado,5141,Trabalhadores Nos Serviços De Administração De Edifícios,690.819995880127,0,1,1
99,Não identificado,5143,Trabalhadores Nos  Serviços De Manutenção De Edificações,1394.1988966200088,-4,7,11
99,Não identificado,5173,Vigilantes E Guardas De Segurança,1912.735986328125,-3,1,4
99,Não identificado,5174,"Porteiros, Vigias E Afins",1850.7049926757813,-2,2,4
99,Não identificado,5191,Motociclistas E Ciclistas De Entregas Rápidas,1471.5650024414063,2,2,0
99,Não identificado,5201,Supervisores De Vendas E De Prestação De Serviços,3183.3475036621094,-3,0,3
99,Não identificado,5211,Operadores Do Comércio Em Lojas E Mercados,1633.9252461751303,-10,9,19
99,Não identificado,5243,Vendedores Ambulantes,1454.4000244140625,-1,0,1
99,Não identificado,6220,Trabalhadores De Apoio À Agricultura,1571.469970703125,1,1,0
99,Não identificado,6225,Trabalhadores Agrícolas Na Fruticultura,1591.2000122070313,-2,0,2
99,Não identificado,7152,Trabalhadores De Estruturas De Alvenaria,1971.030029296875,2,2,0
99,Não identificado,7153,Montadores De Estruturas De Concreto Armado,2424.0333251953125,0,2,2
99,Não identificado,7155,"Trabalhadores De Montagem De Estruturas De Madeira, Metal E Compósitos Em Obras Civis",2319.1566772460938,-1,2,3
99,Não identificado,7156,Trabalhadores De Instalações Elétricas,1893.0800170898438,-2,0,2
99,Não identificado,7170,Ajudantes De Obras Civis,1765.3785574776787,-7,0,7
99,Não identificado,7212,Preparadores E Operadores De Máquinas-Ferramenta Convencionais,2800,-1,0,1
99,Não identificado,7233,"Trabalhadores Da Pintura De Equipamentos, Veículos, Estruturas Metálicas E De Compósitos",2666.5150146484375,0,1,1
99,Não identificado,7242,Trabalhadores De Traçagem E Montagem De Estruturas Metálicas E De Compósitos,2549.60009765625,-1,0,1
99,Não identificado,7243,Trabalhadores De Soldagem E Corte De Ligas Metálicas,4022,-2,1,3
99,Não identificado,7244,Trabalhadores De Caldeiraria E Serralheria,2303.5,2,2,0
99,Não identificado,7632,Operadores De Máquinas Para Costura De Peças Do Vestuário,1412,-1,0,1
99,Não identificado,7711,Marceneiros E Afins,2000,0,1,1
99,Não identificado,7741,Montadores De Móveis E Artefatos De Madeira,2435,-2,0,2
99,Não identificado,7821,Operadores De Máquinas E Equipamentos De Elevação,5550,-2,0,2
99,Não identificado,7822,Operadores De Equipamentos De Movimentação De Cargas,2119,-2,0,2
99,Não identificado,7823,Motoristas De Veículos De Pequeno E Médio Porte,2108.0882975260415,0,2,2
99,Não identificado,7825,Motoristas De Veículos De Cargas Em Geral,2306.1166585286455,-5,1,6
99,Não identificado,7832,Trabalhadores De Cargas E Descargas De Mercadorias,1685,-1,0,1
99,Não identificado,7841,Trabalhadores De Embalagem E De Etiquetagem,1480,1,1,0
99,Não identificado,7842,Alimentadores De Linhas De Produção,1759.239990234375,-3,1,4
99,Não identificado,8110,"Operadores Polivalentes De Equipamentos Em Indústrias Químicas, Petroquímicas E Afins",8125.9501953125,-1,0,1
99,Não identificado,8181,Laboratoristas Industriais Auxiliares,1137.0999755859375,-1,0,1
99,Não identificado,8233,Operadores De Instalações E Equipamentos De Fabricação De Materiais De Construção,1439.1500244140625,1,1,0
99,Não identificado,8484,Trabalhadores Na Degustação E Classificação De Grãos E Afins,1461.199951171875,-1,0,1
99,Não identificado,8485,Magarefes E Afins,1698.4000244140625,-1,0,1
99,Não identificado,8621,Operadores De Máquinas A Vapor E Utilidades,2134.1199951171875,-2,0,2
99,Não identificado,8625,Operadores De Instalações De Refrigeração E Ar-Condicionado,1539.6300048828125,-1,0,1
99,Não identificado,9113,Mecânicos De Manutenção De Máquinas Industriais,3481.5,-1,0,1
99,Não identificado,9511,Eletricistas De Manutenção Eletroeletrônica,2932.9300537109375,-2,0,2
99,Não identificado,9922,Trabalhadores Operacionais De Conservação De Vias Permanentes (Exceto Trilhos),1646.5499877929688,-2,0,2
